***********
*AAAAAAAAA*
*A***A*A*A*
*AAA*AAPAA*
***A****AA*
*A*AAAAA*A*
*A**AA*A*A*
*AAA*AAA*A*
*A*A*AAA*A*
*A*AAGAAAA*
***********
