***********
*AAAAAAPAA*
*A*******A*
*AAA*AAA*A*
*A*A*A*A*A*
*AAAAAAA*A*
****A**A*A*
*GAA*AAA*A*
*A*A*A***A*
*A*AAA*AAA*
***********
