***********
* *       *
*    ** * *
*   *   * *
* *** *** *
* * *   * *
* * * *** *
*P      * *
*** *** * *
*        G*
***********
