***********
*AAAAAAA*A*
*A*******A*
*A*AAA*AAA*
*A*A*A*A*A*
*AAG*AAA*A*
******AA*A*
*AAAAA*AAA*
*A*A***A***
*AAAAAAAAP*
***********
