***********
*     *   *
****  * ***
* *   *   *
* * ***** *
*   *     *
* *****  **
*G*   *   *
* * *  ** *
*   *    P*
***********
