***********
*         *
* * * *** *
* *    P* *
* ** ** * *
* *   *   *
* * ***** *
*   *   * *
*****  ** *
*        G*
***********
