***********
* *    P* *
*    ** * *
* * *   * *
* * * * * *
* *   * * *
* ****  * *
*G    * * *
* *** * * *
*   *     *
***********
