***********
*AAAAA*AAA*
*A*A**AA*A*
*AAAAGAA*A*
*******A*A*
*AAAAAAAAA*
*AA**AAA*A*
*A*AAAAAAA*
*A***A***A*
*AAAAA*AAP*
***********
