***********
*AAA*GAA*A*
*A*A*A***A*
*A*A*A*AAA*
*A*A*A*A*A*
*A*A*AAA*A*
*A******AA*
*AAAAA*AAA*
*A***A*A***
*PAA*AAAAA*
***********
