***********
*AAAAAAGAA*
*A*A*A***A*
*A*AAAAAAA*
*A*****A***
*AAAAA*AAA*
*****A***A*
*AAP*AAAAA*
*AAA*A*****
*AAAAAAAAA*
***********
