***********
*AAAAAAAAA*
*A*A***A***
*A*AAA*AAA*
*A*A*A***A*
*AAA*AAA*A*
*A*A***A*A*
*P*AAA*A*A*
*A***AAA*A*
*AAAAA*GAA*
***********
