***********
*       * *
* *** * * *
* * *G    *
* * * *** *
* *       *
* ***   * *
*     * * *
***** * * *
*P        *
***********
