***********
*GAA*AAAAA*
*A***A***A*
*AAAAAAA*P*
*AA*A**A*A*
*A*AAAAA*A*
*AAA*A*A*A*
*AAA*A*AAA*
***A*A***A*
*AAAAAAAAA*
***********
