***********
*AAA*A*A*A*
*A*A*A*A*A*
*A*AAA*A*P*
*A***A*A*A*
*AAG*AAA*A*
*AAA***A*A*
*A*AAA*AAA*
*A***A***A*
*AAA*AAAAA*
***********
