***********
*AAAAAAA*A*
****AA*A*A*
*GAAAAAAAA*
*A*A*****A*
*AAA*AAAAA*
***A*****A*
*AAAAAAA*A*
*AA****A*A*
*PAAAAAA*A*
***********
