***********
*AAAAAAAAA*
*A*****A*A*
*A*AAP*A*A*
***A*A*A*A*
*AAAAAAA*A*
*A***AAA*A*
*A*AAA*AAA*
*A*A*****A*
*GAA*AAAAA*
***********
