***********
*    G    *
*******   *
*       * *
* ***** ***
*     * * *
* ***     *
*P    *   *
*** * * * *
*   *     *
***********
