***********
*PAAAAAAAA*
*A***AA**A*
*A*A*AAAAA*
*A*A**AA*A*
*AAAAA*A*A*
**A**A*A*A*
*AAAAA*A*G*
*A*****AAA*
*A*AAAAA*A*
***********
