***********
*AAAAAAAAP*
***A*A*A*A*
*AAA*A*A*A*
*A***A*A***
*AAAAA*AAA*
*A*****AAA*
*G*AAAAA*A*
*AAA*AAA*A*
*AAA*A*AAA*
***********
