***********
*AAA*AAAAA*
*A*A***A*A*
*PAAAAAA*G*
*A***A*****
*A*AAAAAAA*
*A*******A*
*AAAAA*AAA*
*****AAAAA*
*AAAAAAA*A*
***********
