***********
*   *    P*
*** * * * *
* *     * *
* * * *** *
*   *     *
* * * * * *
*   *G* * *
**  *** * *
*       * *
***********
