***********
*   *     *
* * * * * *
* *   * *G*
* ***** * *
* *   * * *
* * * **  *
*   *     *
* ***** ***
*P        *
***********
