***********
*AAA*AAAAA*
***A*A*A*A*
*PAA*A*AAA*
*A**AA***A*
*AAAAA*AAA*
*A*AAA*AA**
*A*A*A*AAA*
*A***A*AAA*
*AAGAAAAAA*
***********
