***********
*AAA*AAAAA*
*A*A*A***A*
*P*A*A*AAA*
***A***A***
*AAAAA*AAA*
*A***A*A*A*
*A*AAAAA*A*
*A*******A*
*AAAAAAGAA*
***********
