***********
*   *     *
* * * *** *
*  G  *   *
* *** * ***
* *       *
* ****** **
*     *   *
* *** *  **
*P  *     *
***********
