***********
*AAA*AAAAA*
*AAAAA*A*A*
*A*AAAAP*A*
*A***A*A*A*
*AAAAAAA*A*
*AAA*A*****
*AAA*A*AAA*
*A**AA***A*
*AAAAAAAAG*
***********
