***********
*GAA*AAP*A*
*A**AA*A*A*
*AAAAA*AAA*
******A**A*
*AAAAAAA*A*
*A*A***A*A*
*A*A*AAAAA*
*AAA*A*****
*A*AAAAAAA*
***********
