***********
*         *
*** ***** *
*P  *     *
* *** ** **
*         *
* ******* *
* *      G*
* * ** ****
*         *
***********
