***********
*AAAAPAAAA*
*A*A*A*****
*AAAAAAAAA*
*A*******A*
*A*AAGAA*A*
*A*A*****A*
*AAA*AAAAA*
*A*A***AAA*
*A*AAAAAAA*
***********
