***********
* *      P*
* * * * * *
*   * * * *
* *** * * *
*     * * *
***** * * *
* *  G* * *
*    ** * *
*   *     *
***********
