***********
* *P      *
* * * *** *
*   *     *
* ** **** *
*   *     *
* *** *** *
* *   *   *
*** *** ***
*   *G    *
***********
