***********
*AAAAPAAAA*
*A***A***A*
*AAA*AAA*A*
***A***A*A*
*AAAAA*A*A*
*A*****A*A*
*A*AAA*AAA*
**AA*A*A*A*
*AAAAAAA*G*
***********
