***********
*AAPAAAAAA*
***A*A*A*A*
*AAA*AAAAG*
*A***A***A*
*A*AAAAA*A*
*A*A***A*A*
*A*AAAAA*A*
*A*A*A***A*
*AAA*AAAAA*
***********
