***********
*PAAAAAAAA*
*****AAA*A*
*AAAAA*AAA*
*A**A****A*
*AAAAAAA*A*
*****AAA*A*
*AAA*A*A*A*
*A*AA**AAA*
*A*AAAAG*A*
***********
