***********
*         *
* ** ** * *
*    G  * *
******* * *
*         *
*   ***   *
*       * *
* *** *** *
*   *P    *
***********
