***********
*     *   *
* ***   * *
*       * *
* * * **  *
* *   *  G*
*  *  *****
*   *   * *
*** * * * *
*P    *   *
***********
