***********
*AAG*AAAAA*
*A*A*A***A*
*A*AAA*AAA*
*A*A*A*AA**
*A*A*AAAAA*
*A***A***A*
*A*PAA*AAA*
*A*A***A*A*
*AAAAA*A*A*
***********
