***********
*AAAAAAA*A*
***AA*AAAA*
*PAA*A*AAA*
*A***A*A*A*
*AAA*AAAAA*
*A*AAA**A**
*A*A*AAGAA*
*A*AAA***A*
*A*AAA*AAA*
***********
