***********
*AAAAGAAAA*
*AA***AA***
*AAA*A*AAA*
***A*A***A*
*A*AAA*AAA*
*A***A*A*A*
*AAA*A*A*A*
*A***A*AAA*
*AAAAAAPAA*
***********
