***********
*   *  P* *
*     * * *
* *       *
* *********
*G        *
* * ** ** *
*   *   * *
* *** *  **
*     *   *
***********
