***********
* *       *
* *  **** *
*  P  *   *
* * ***   *
*   *   * *
* *** **  *
*   *   *G*
***  **  **
*         *
***********
