***********
*A*AAAAAAA*
*A*AAA**A**
*A*A*GAAAA*
*A*AA***A**
*AAA*AAAAA*
*A*****A*A*
*A*AAA*A*A*
*A*A*AA**A*
*PAA*AAAAA*
***********
