***********
*AAAAAAPAA*
*A*AA****A*
*A*A*A*AAA*
*A*A*A*A***
*A*A*AAAAA*
***A***A***
*AAG*AAAAA*
*A**A**A*A*
*AAAAAAAAA*
***********
