***********
*     *G  *
* * * **  *
* * *   * *
* * *** * *
*P*       *
* **** ** *
*   *     *
* * * *****
*         *
***********
