***********
*AAA*AAAAA*
*A*A*A***A*
*A*AAAAA*A*
*A***A*A*A*
*A*AAAAA*A*
*AAA*****A*
*P*A*AAA*G*
*A*A*A*A*A*
*AAAAA*AAA*
***********
