***********
*   *   *P*
**    * * *
* * * * * *
* * * * * *
* *   *   *
* **** ** *
*G        *
*     *****
* *       *
***********
