***********
*        P*
* ***** * *
* *       *
*    **** *
*G* *     *
* * *** ***
* * * * * *
* * * * * *
* *       *
***********
