***********
*AAAAAAAAG*
*AA****A*A*
*AAAAAAA*A*
**A*****AA*
*AAPAA*AAA*
*AAA***A***
*AAAAAAA*A*
*A*A*****A*
*AAAAAAAAA*
***********
