***********
*A*AAAAAAA*
*A***A**AA*
*AAAAAAA*A*
*******A*A*
*AAA*AAA*A*
*A***A*A*A*
*GAAAA*PAA*
*A***A*****
*AAAAAAAAA*
***********
