***********
*AAPAAAAAA*
***AA****A*
*AAA*AAAAA*
*A***A*A***
*A*AAA*AAA*
*A***A***A*
*AAA*A*AAG*
*A*A*A*A***
*A*A*AAAAA*
***********
