***********
*         *
* * * *****
*   *     *
***  **** *
*   *   * *
* *****  **
*     *  G*
***** **  *
*  P      *
***********
