***********
*         *
* * *** * *
*  P*     *
***   ** **
* * *     *
* * ***** *
* * * * *G*
* * * * * *
*     *   *
***********
