***********
*AAA*AAAAA*
*A**AA**AA*
*A*AAG*A*A*
*AAA*A*A*A*
*A*AAAAA*A*
*A***A***A*
*AAA*A*AAA*
*AA**A*AAA*
*AAAAPAAAA*
***********
