***********
*        G*
*** ** ** *
*   *     *
* ** **** *
* *     * *
* * * * ***
*        P*
* *** *** *
*   *     *
***********
