***********
*AAAAAAAAG*
*A*A*A*A*A*
*AAAAAAA*A*
*********A*
*AAAAAAAAA*
*A*****A*A*
*A*AAAAA*A*
*A*AA**A*A*
*AAPAA*A*A*
***********
