***********
*AAA*AAAAG*
***A*A***A*
*AAA*A*AAA*
*A***A*AA**
*AAPAAAA*A*
**A****A*A*
*AAAAA*AAA*
*A***A**AA*
*AAA*AAAAA*
***********
