***********
*A*AAGAAAA*
*A**AA*A***
*AAA*AAAAA*
***A*****A*
*A*AAAAA*A*
*A*A*A*A*A*
*A*P*A*AAA*
*A*A*A***A*
*AAAAA*AAA*
***********
