***********
*AAA*A*AAA*
***A*A*A***
*AAA*A*AAA*
*A***A***A*
*AAAAAAAAA*
*A*A***A*A*
*GAA*AAP*A*
*A***A***A*
*AAAAAAAAA*
***********
