***********
*AAA*AAAAA*
*A*A*A***A*
*A*AAA*PAA*
*A****AA*A*
*AAA*G*A*A*
***A*AA**A*
*A*AAA*AAA*
*A**AA*A*A*
*AAAAAAA*A*
***********
