***********
*AAAAAAGAA*
*A***A*A*A*
*AAA*A*A*A*
*A*A*A*AAA*
*A*A*AAA*A*
***A*****A*
*A*A*AAA*A*
*A*A*A*A*A*
*AAP*A*AAA*
***********
