***********
*AAAAAAAAA*
**AAAA***A*
*AAAAAAGAA*
*A***A*****
*AAA*AAAAA*
*A*A**A****
*A*AAAAAAA*
*A**A******
*AAAAAAAAP*
***********
