***********
*AAPAAAAAA*
*AAA*A*A*A*
*AAA*AAAAA*
*AAA**A****
*A*AAA*AAA*
*AA**A*A***
*A*A*A*A*A*
*A*A*A*A*A*
*GAAAAAAAA*
***********
