***********
*A*AAAAA*G*
*A*A***A*A*
*A*AAAAA*A*
*A*AAA*A*A*
*A*A*A*AAA*
*A*A***A*A*
*AAAAAAA*P*
*AA*A****A*
*AAAAAAAAA*
***********
