***********
*GAAAAAAAA*
**AA***A*A*
*AAA*AAA*A*
*A***A*A*A*
*AAAAA*P*A*
*******A***
*AAAAAAAAA*
*A*A*A***A*
*AAA*AAAAA*
***********
