***********
*AAPAA*AAA*
*AA******A*
*A*AAAAAAG*
*A*A*******
*AAA*AAAAA*
*A***A*****
*AAAAAAAAA*
***A*****A*
*AAAAAAAAA*
***********
