***********
*         *
*    ***  *
*   *     *
* **  *****
*P* *     *
* * *******
* *       *
* *** *** *
*        G*
***********
