***********
*AAAAAAGAA*
*A***A**AA*
*AAA*AAA*A*
*A***A*A*A*
*AAA*AAA*A*
*A*A**AA*A*
*A*AAAAP*A*
********AA*
*AAAAAAAAA*
***********
