***********
*        G*
* *** * * *
* *       *
* *** *** *
*   *     *
*** *******
*   *     *
* * * * * *
*P    *   *
***********
