***********
*   *     *
* * * * ***
*   * *   *
* * * ** **
* *  G*   *
* * * * * *
*        P*
* ***** * *
*         *
***********
