***********
*AAAAA*AAA*
*A*A*AAA*A*
*A*AAA*A*A*
***A*A*AAA*
*GAA*AAA*A*
*A*********
*AAAAAAAAA*
*A*******A*
*AAAAAAPAA*
***********
