***********
*         *
* ****  * *
*     *  G*
* **  ** **
*   *     *
**   **** *
*   *     *
* *** *   *
*P*   *   *
***********
