***********
*AAAAAAAAA*
*********A*
*AAAAA*AAA*
*A*A*A*A***
*P*AAA*AAA*
*AAA****AA*
*A*AAAAAAA*
*A*****AA**
*AAAAAAGAA*
***********
