***********
*AAAAAAAAA*
*A***A***A*
*PAA*A*AAA*
*A***A*A***
*A*AAA*AAA*
*A*A*****A*
*A*AAAAG*A*
*A*****A*A*
*AAAAA*AAA*
***********
