***********
*AAAAAAG*A*
*A*****A*A*
*PAA*A*AAA*
*A*AAAA**A*
*A*AAAAAAA*
***A***A*A*
*AAA*AAAAA*
*A****AA*A*
*AAAAAAA*A*
***********
