***********
*AAA*AAA*A*
*A*AAA*A*A*
*A*A*A*AAA*
***A*****A*
*AAAAAAA*A*
*A*******A*
*AAAAAAAAA*
*A**A**AA**
*PAAAAAAAG*
***********
