***********
*AAAAA*AAA*
***AAA*A*A*
*AAA*G*AAA*
*A*****A*A*
*AAAAA*A*A*
****AA***A*
*AAAAAAA*A*
*A*******A*
*PAAAAAAAA*
***********
