***********
*   *P  * *
* **      *
*   * * * *
* * * * * *
* * * * * *
* * *  ** *
* *   *  G*
* * *** * *
*         *
***********
