***********
*AAAAAAAAA*
*****A***A*
*AAAAA*A*A*
*AA***AA*A*
*AAGAAAA*A*
*****A**AA*
*AAAAAAAAA*
*A**A*A****
*AAAAAAAAP*
***********
