***********
*GAAAAAAAA*
*A****A**A*
*A*A*AAAAA*
*AAA***A*A*
*AAAAAAA*A*
*A*A*A*A*A*
*P*AAA*A*A*
*A***A*A*A*
*AAAAAAA*A*
***********
