***********
*AAAAAAAAA*
*A*A****AA*
*P*A*AAA*A*
*A*A*A***A*
*A*A*AAGAA*
*A*A*AA*A**
*A*A*AAA*A*
*A*A*****A*
*A*AAAAAAA*
***********
