***********
*A*AAAAA*A*
*A*A*****A*
*AAAAAAA*A*
*A***AAA*A*
*GAAAA*A*A*
*AAA***A*A*
*AAA*A*A*A*
*****A*A*A*
*AAAAAAAAP*
***********
