***********
* *   *   *
* * * * * *
* *     * *
* * ***** *
*   *     *
* ***** * *
* *    G  *
* *  ** * *
*P  *     *
***********
