***********
*AAPAAAAAA*
*A**AA***A*
*A*AAAAAAA*
*A*A***A*A*
*AAAAA*A*A*
*A*A**AAAA*
*A*AAAAA*A*
*A*A*****A*
*AAA*GAAAA*
***********
