***********
*AAAAAAAAA*
*A*A*A*A*A*
*A*A*AAG*A*
***AA****A*
*PAA*AAAAA*
*AA*AA*A***
*A*AAA*AAA*
*A*A*A*A*A*
*AAA*A*AAA*
***********
