***********
*AAAAAAAAA*
*AAA*A*A***
*A*AAP*AAA*
*****A***A*
*AAA*AAA*A*
*A*A*****A*
*A*AAAAA*A*
*A*A*****A*
*AAAAAAGAA*
***********
