***********
*AAAAPAAAA*
*A***A***A*
*A*AAA*A*A*
***A*A*A*A*
*AAAAA*AAA*
*A**AA***A*
*A*AAAAA*G*
*A*****A*A*
*AAAAAAA*A*
***********
