***********
*AAAAAAA*A*
*A**A*AA*A*
*P*AAA*AAA*
*A*A*AA**A*
*AAA*AAGAA*
**A***AA*A*
*AAA*AAA*A*
*A***A***A*
*AAAAA*AAA*
***********
