***********
*AAGAAAAAA*
*A*AAA*****
*AAA*A*AAA*
**AA***A*A*
*AAA*AAA*A*
*AA**A***A*
*AAAAA*P*A*
*A*****A*A*
*AAAAAAAAA*
***********
