***********
*PAAAAAAAA*
*A****A**A*
*AAAAAAAAA*
*********A*
*A*AAAAA*A*
*A*A***A*A*
*GAA*A*AAA*
*A*AAA*****
*AAAAAAAAA*
***********
