***********
*AAAAAAAAG*
*A***A*A*A*
*AAA*AAA*A*
***A*AA**A*
*A*A*A*AAA*
*A*A*A*AAA*
*A*AAPAA*A*
*A*A*****A*
*AAAAAAA*A*
***********
