***********
*PAA*AAAAA*
**AAAA***A*
*AAA*AAA*A*
*A*****AAA*
*A*AAAAA*A*
*A*A*A***A*
*A*A*GAAAA*
*A*A*A*****
*AAAAAAAAA*
***********
