***********
*    G    *
* ***** * *
*   *   * *
**  * * ***
* * *     *
*   * * ***
*     *   *
*   * * * *
*  P    * *
***********
