***********
*     *   *
* * * * * *
* *     * *
*** **  * *
*  G* * *P*
*  ** * * *
* *   *   *
* * ***** *
*         *
***********
