***********
*AAG*AAA*A*
*A*A*A*A*A*
*A*AAA*A*A*
*A****AAAA*
*AAAAA*AAA*
*****A***A*
*AAA*AAA*A*
*A*****A*A*
*AAAAAAP*A*
***********
