*********************
*     *         *   *
* *** * * ** * ** * *
*  P    * *       * *
*  ****** * ** **** *
* *   *   *   *     *
* * * * * *** * *** *
* * * *   * * * *   *
* * * * * * * *** ***
* * *       *   *G  *
* * * ********* *** *
* *       *     *   *
* ******* * ***** * *
* * *     *     *   *
* * * * ******* * ***
*   * * *   *   *   *
***    ** * * **  * *
*   *     * * *     *
* *** * **    ***** *
*   *               *
*********************
