*********************
*                   *
** **** *****  **** *
*     *       *   * *
* * * *** * * * * * *
* *  G  *   *   *   *
* * *** *** *  ******
*     *   * * *     *
* *** **  *** * *** *
* * *   *     *   * *
* * *** * * ***** * *
*     *   * *       *
* **  *** **  ****  *
*     * *   * *   * *
***** * *** * * * * *
*   *     * * * * * *
* **** ** *   *** * *
* *     * *   *   * *
* * * ***   * * *** *
*   *  P  *     *   *
*********************
