*********************
*       *   *       *
* *** *** * * ***** *
*     *   * *     * *
* ***** ***   *** * *
* *     *     * * * *
*   ***** *****   * *
* *       *     * * *
* ******  * ***** * *
*         * *     * *
****  *** * *** *** *
*    G*   *   * *  P*
* * *** ***** * * ***
* * *   *   *   *   *
* * * *** * *****   *
* * *     *       * *
* * *** * ***** *** *
*       * *         *
* * * ***   ***** * *
*                   *
*********************
