*********************
*         *     *   *
* * *   * *  ** * * *
*   *     * * *   * *
* ***** *   *  * ** *
*   *   * *   *   * *
* * * ******  * * * *
* *   *     *     * *
*  ** * * * *  ** * *
*   * *G* *   *     *
* * *** * *** * ** **
* *     * *   *     *
*  ****   *  **** * *
*   *   * * *     * *
*** *** * *** *   * *
*   *   *     * *   *
* *** * ******* * * *
* *       *   * *   *
* * ***** *** * * ***
*   *      P        *
*********************
