*********************
*             *     *
***** * ***** *     *
*     * *   *   *   *
* *   * * **  * * * *
* * *     *   * * * *
* * ***  **   * * * *
* *     *     * * * *
*  ** *** * * * * * *
* *           * * * *
* * ***  ** *** * * *
*   *G    * * * * * *
* * * *  **** * *   *
* * * *       * *   *
*   * * *** * * * * *
* *   *   * * * * *P*
* *** ***** *** * ***
*   *     *     *   *
* * ***** ********  *
* *                 *
*********************
