*********************
*           *   *   *
* * *** **    * * * *
* * *     * * *   * *
* * **  *** *  **** *
* *   *   * *   *  G*
* *** *** * * *  ****
* * *   * * * *     *
* *  ** * * * * **  *
*     * *   * *   * *
******* * ***** * * *
*               *   *
* * * ***** ******* *
* *   *       *     *
* ***** **  * *** ***
*                   *
* * *** **  ***** * *
*P* * * *   *   *   *
* * * * ***** * *** *
*     *       *     *
*********************
