*********************
*  G*         * *   *
* **  * * * * * * * *
*     *   * *   * * *
******* * * *   *   *
*   *     *       * *
* * * *** * * ***** *
* *     *   *       *
* ** ** * ********* *
* *                 *
* *** * ***  ** *** *
*   *   *     *     *
*** *  ** ***********
*   *       *       *
* *** ** **** ****  *
*   *        P*   * *
* * *** **** ** *****
* *     *   *       *
* ***  **    ****** *
*         *         *
*********************
