*********************
*             *     *
* * ****** **    ** *
* *   *       * * * *
* *** ********  * * *
* * * *           * *
* * *   **** *****  *
* * *       *       *
* * ***** * * ***** *
* *    G  * *       *
* *** ***** * **  ***
*   * * *   *   *   *
*** * * *******  ** *
* * * *       *     *
* * * **** ** *** * *
* * *         *   * *
* *   * ***   * *** *
* *         *   *   *
* ***** ******** ** *
*              P    *
*********************
