*********************
*    P        *   * *
* ***   * * * * * * *
* *   *     *   * * *
* *   **** ** *** * *
* *   *     *   *   *
* *** * *** * *** * *
*   *   *   * *   * *
*** *** * *** * *** *
*   *       * * *   *
*  **** ***     *   *
* *   *   * *     * *
* * * * *** ******* *
* * *   *G  *   *   *
* * * *** * * * * ***
*   * *   *   *     *
*****   *** *** *** *
*   *             * *
* * *  ****** **  * *
*           *     * *
*********************
