*********************
* *                 *
* *  ****** ******* *
* * *       *       *
* * * * * *** ***** *
* * *   * *G  *     *
* *   *   * *********
*   * * * *         *
* ***** * **  ***** *
*   *   * *         *
**  * *** * ***   * *
*   * * *   * * * * *
* *** * ** ** * * ***
* *   *         *   *
* *** *** * ******* *
*   *     *   *   * *
*** ***   *** * * ***
* * *     * *   * * *
* * * ***** * * * * *
*P    *         *   *
*********************
