*********************
*           *   *   *
* ** ****** * *   * *
* *           * * * *
* * ** ** *** * * * *
*   *   *   *   * * *
* *** *   *   * * * *
* *   *G* * * *   * *
* * *** *** * * *** *
* * * *     *   * * *
*** *   ***** *** * *
*   *   *       *   *
* **  * *  ** * * ***
* *   * * * * * * * *
*** *** * * * *** * *
*   * *   * *   * * *
* * * ***** *** * * *
* *       *   *P* * *
*  ****** **  * * * *
*             *     *
*********************
