*********************
*   *               *
* * * ********* *** *
* *     *   *   *   *
*** *** * **  *** * *
*     *       *     *
* ******* * * ***** *
*      P  * * *     *
*********** *** * * *
*   *     *     * * *
* * * ***     *** * *
* *   *   *   * *   *
*  ****  **** *   * *
* *   *   *   * *   *
* * * *** * *   * * *
* * *   * *       * *
* ***** * *** ****  *
* *   * * *         *
* * * *   *  * **** *
*   * *    G        *
*********************
