*********************
*     *       *     *
* * * * *  **  **   *
*   *     * *   * *G*
* ** *****   ** * * *
* *       *     * * *
* * ** ** * ***** * *
* *    P* *       * *
* *     * ********* *
*   * * * *         *
*** * * * * **** ****
*     *   * *       *
* *****  ** * ***** *
*           * * *   *
* *** * * * * * * ***
*   *   * * * *     *
*  *****  * * * *** *
* *   *   *   *     *
* * * *   ******* * *
* * *   *           *
*********************
