*********************
*   *           *   *
*** *  ******** * * *
*   * *       * * * *
* * * * ******* * * *
*   *   *     *   * *
* * ****  * *** *** *
*       * *         *
** ** * * ******* * *
*       *     *G    *
* *** * ***** *     *
* *     *     *   * *
* *** *** ***** *** *
*P  * *           * *
* *  ** ********* * *
* *   * *         * *
* **    *** *** * * *
*   * *           * *
**  * *** *** *** * *
*                   *
*********************
