*********************
*             * *   *
* *** * * ***       *
*     *   *   *   * *
*** * * *   **  *** *
*   *     *         *
* ****** **   * *   *
*           *     * *
* ***  ** * * ****  *
*   *     *       * *
* *     **** ****   *
*   * *G      *     *
*** * * * *** * **  *
*   * *   *         *
* *** *** **** ***  *
* * *   *     * *   *
*   *** *****   * ***
* *   *       * *   *
* *** ********* * * *
*     *            P*
*********************
