*********************
*   *               *
* *** *  *  * *** * *
*   * * *   * *     *
*** * * *   *   * * *
* * * * *       *   *
* * * *   * ***** ***
*   * *   *     *   *
* * * **  * *** *** *
*   *   * *   *   * *
* ***** * * * * *** *
* *       *   *     *
* ***  ** ***** * * *
*G  *         * * * *
***    **** * * * * *
* * * *     *   * * *
* * * * *** * *** * *
* * * * *   *       *
* * *** * *** **  * *
*       *     *    P*
*********************
