*********************
*     *             *
* * *** *** *** * * *
* *   *   *    P*   *
*  ** *** ********* *
*   * *   *         *
*  ** *  *  ******* *
* *   * *   *       *
* * ***   *** * * ***
*         *   * *   *
* ******* * * * *** *
* *   * * * *     * *
* * * * * *** ***** *
*   *   *   *     * *
******* *** *  ** * *
*G    * * * *   *   *
*  **** *   *** *****
* *       * * *   * *
*   ******* * ***   *
*           *       *
*********************
