*********************
*       *   *       *
* * **  * * *** * * *
*     *   *     * * *
* *** ******* * * * *
* *   *       *     *
* * ***    **** *** *
* *   *            G*
*** * * * ***  **   *
*     *     *   * * *
* ***** * * * * *   *
*   *   * *   *   * *
*** ***** *****  *  *
*   *   * *     *   *
*  ** *** *** *** ***
*   *P*     *   *   *
*** *   *** **** ** *
* *   * * *   *   * *
* * *** * ***   * * *
*           *   *   *
*********************
