*********************
*   *               *
* * * ******** ** ***
*     *G        *   *
* **** **** ***** * *
* *         *     * *
* ***** * *** *** * *
*       * *   * * * *
** ***** ** **  *** *
*           * *     *
* ***** * * * * * * *
*     *     * *     *
*****  *  * * * *** *
*         * *       *
* * ******* * ***   *
* *   *         * * *
* * * * ***** *** * *
* *   *     *   *P* *
* * ******* *     * *
* *               * *
*********************
