*********************
*     *       *   * *
* * *** *  *  *   * *
* * *   *           *
* ***  ** * ******* *
*   *   * *  P    * *
*** *** **  *** *   *
*     *   *   * * * *
* *** *** ***** *   *
*     * *   *     * *
* *  ** ***   * * * *
* *           * *   *
* ******* ***** *** *
*     *         *   *
* **  ***** *** * * *
*       *       * * *
******* *   *** **  *
*       *         * *
* *** ***** ***   * *
*            G  *   *
*********************
