*********************
*                   *
* ******   * ****   *
* *     *   *     * *
* *  ** **  *  ******
* *   * *   *G      *
** **   * ** ****** *
*     *     *   *   *
* ***** **    * * * *
*             *   * *
* * * * * ***** *** *
* * * * *   *     * *
* * * * **  * *** * *
* * * *     *   *   *
*** ********* * *****
*           *   *   *
* *** ***** * ***** *
*     *   *   *   * *
* *** * * ***     * *
*              P*   *
*********************
