*********************
*   *   *           *
* *** * * **  ** ** *
*     *G  *         *
* *** * *   * *  ****
*   *       * *     *
* * * * ***** ***** *
* *   *   *   *   *P*
* * * * * * **  * * *
* *     * *     *   *
* * * **  ****** ** *
*   *   *       *   *
*  *  * * * * * * ***
*   *   * * *       *
* * *   * * ** ** * *
* * * *     *   *   *
* ******  * *   *** *
*   *   * * * *     *
***   * * * * * *** *
*     *   *         *
*********************
