*********************
*                   *
* **** **** * * *** *
* *         * *   * *
* *********** *   ***
*       *       *   *
* * **  *   ******* *
*   * *   * *       *
***** *** * *  ** * *
*     *   *     *   *
*   * * *******  ** *
*   * * *       *   *
*** * * *  ** *** * *
*   *G*         * * *
*  ***  *** * *** * *
*       *   *     *P*
* * *  ** **    *** *
* *   *   * *   *   *
* * *** *** *****   *
* *               * *
*********************
