*********************
* *       *         *
* * ***** ******* ***
*   *   *       *   *
* * * ***  *****  * *
* * *     *     * * *
* * * *** * *** * * *
*   * * *   * * * * *
*   * * ****  * * * *
*P*           *   * *
* ***** ******* *** *
*             *   * *
* * ********* * *** *
* * *     *    G  * *
* *   *** *  **** * *
* *   *   *         *
*   *** **  *   *** *
* *   * *     *   * *
*  **** * * *  *  * *
*       * *         *
*********************
