*********************
*       *   *G    * *
* * * * * *** * * * *
* *   * *     *     *
* ***    ** * ***** *
*   *   *   *     * *
* *   *** * * ** *  *
* *   *   *       * *
*** *   *** * * *** *
*   *   *   * *     *
* ***** * *** * *****
* *       *   *   * *
* ***** * *  **** * *
* *     * * *   * * *
* * ***   * *** *   *
*   * *P*       *   *
* ***   *********** *
* *   * *         * *
*   * * * ******* * *
*   * *             *
*********************
