*********************
*           *       *
* ***** ** ** * *** *
*  G  *   *   * *   *
* *   **    *** *** *
* * *   *   * *   * *
* * ***  ***   ** * *
* * *           * * *
* *   ** ** * ***   *
* *       * * *   * *
* *** * * *** * * * *
*   * * * *   *     *
*** *** *   *** * ***
* *     *   *   * * *
* **  *****   * * * *
*   * *   *   *   * *
* *** * *   * * * * *
*    P* * * * *     *
* ***** ** ** * *** *
*     *       *     *
*********************
