*********************
*         *         *
* ***** * * ***** * *
* *   *         *   *
* * * ******* * * * *
* * *  G    * *   * *
* * ** ** * * * * * *
* *   *       * *   *
*  ***  ***** ***** *
*     *     *       *
* * *   *** * * *****
* * * *   * * * *   *
* * * ***** **     **
* * *     * *   * * *
* * ***** * * * * * *
* * * *   * * * *   *
*   * * ***   ***** *
* * *   *   * *     *
* *   *** * * * *****
*P  *               *
*********************
