*********************
*                   *
** ** * *  * ****** *
*       *   *       *
* ***** * * ******* *
*     *           * *
* * * **  *   * * * *
* * * *     *   * * *
* * *   *** * * * * *
*           *G* * * *
********* * * * * ***
*         *   * *   *
* *******  **** **  *
* *     * *       * *
*   *** * ******* * *
* * * * * *       * *
* * * * *** *** **  *
*   * *     *   *   *
* * * ******* *** ***
*      P    *       *
*********************
