*********************
*                   *
* * * *** ******* * *
* * *   * *  P    * *
*   *** * * * *******
* *   *   * *   *   *
* * *  ** * *** * * *
* * * *     *   * * *
* * * ****  * **  * *
* * *       *   * * *
* * ****  *** * * * *
* *   *     * *   * *
* *** *   * *** * * *
*     *       *     *
****  * * *** *  *  *
*     * *     * *   *
* ***** ******* * ***
*   *G  *     * * * *
*** * ***** * *     *
*   *       *   *   *
*********************
