*********************
*               *   *
*  **  ****** * *** *
*   *   *   * *     *
**  * * * *   ***** *
*   * * *           *
* * **  **  * * *****
*P*       *     *   *
* *** * *** *** * * *
*       *   *   * * *
**  *   *  ** *** * *
*   * *   * * *   * *
* *****  *  * ** ** *
* *         *G  *   *
* * *****  **** * ***
*   * *         *   *
* * * * ** **** * * *
*   * * *         * *
****  * *****  ** * *
*             *     *
*********************
