*********************
*       *           *
***     * ****** ** *
*   * *       * *   *
*** * * *** * * * ***
*   * *   *   * *   *
* *** *** *** * * * *
*     * *     * *   *
******  ***     * ***
*   *   *   *   *   *
* * *** *  **** *** *
* *     *     *     *
* * ***   * * *** * *
*     *P    * *   * *
* **  *  * ** ***   *
*     *   *   *    G*
* *** ***   *** **  *
* *   *   *     *   *
* * *** * *** * * ***
* *     *           *
*********************
