*********************
* *       *     *   *
*   *** * ***   *   *
* * *       * *   * *
* *   ****  * * *** *
*   * *       *  P  *
* **  * ** ****   * *
*   *G* *         * *
***** * * ***   *** *
*     * * *     * * *
* ******* * ***** * *
* *             *   *
* * ***   ***** * ***
*     * * *     * * *
* * *** * * ***** * *
* * *           *   *
* * * ******* * *** *
* * * *           * *
* * * * * *** * **  *
*   *               *
*********************
