*********************
*   *       *   *   *
* * * * * * * * * * *
* * * * * *   * * * *
*** * * * *  ** *   *
*   * * * *     * *G*
* *** * * * *   * ***
* *   *   * *   *   *
* *  ** * * ** ***  *
* * *  P* *       * *
*       * * * *** * *
*   * * * *     *   *
* *** ***   *** *****
*   *   *   *   *   *
***   * *  ** *** * *
* * * *     *     * *
* *   * ***   ***** *
*   *   *   *     * *
* ***** * * * ***** *
*         * *       *
*********************
