*********************
* *  P  *     *     *
* * * *** * *  * ** *
* * *     * *       *
* * ** **** ** ***  *
* *     *   *     * *
* *** * * **  * * * *
*     * *     *     *
* * * *   * * *** ***
*     *   * *   *   *
* *  **   * ** ** * *
*           *     * *
**  * ***** * * **  *
*  G            *   *
*** ***   *  * **  **
* * *           *   *
* *** ********* *** *
*     *       *   * *
* *****  *******    *
*                   *
*********************
