*********************
*         *         *
* * ***   * * *** * *
*P* *   * *   *   * *
* * * *** ***** *** *
*   *   *       *   *
** ** * * ******* ***
*   * * * * *   *   *
* * *** *** * * *** *
* *   * *   *       *
*  ** * * **** ** ***
*         *         *
* ******* * *** *** *
*     *   *G  *     *
* *** * * *** * *****
*   * * *     *     *
***   * *** *** *** *
*           *   *   *
* *** ****  * **    *
*                 * *
*********************
