*********************
* *               * *
* * ********* * * * *
* *         * * *   *
* * *** *** * *   * *
*   *   * * * *     *
* *** ***  ** ***** *
*   *       *       *
* * * * *** * * *** *
*     *   *   *   * *
* ******  * * * * * *
*   *     *   * *   *
***   * * *** * *****
*   * *       *     *
* * * **  * * * * * *
* * * *     *   * * *
* *   * * * * *** * *
*G* * *   *       *P*
* * * *** ****** ** *
*     *             *
*********************
