*********************
*         *         *
*  **** * * ******* *
* *   * * *   * *   *
* **  * *  ** * * * *
*     * *   *     * *
*** * * ***** * * ***
*     * *     * *   *
*  ** * * ***** *** *
* *   * * *     *  G*
* * *** * **  * *  **
*P  *       * * *   *
* *** * **   *  *** *
* * * *   * *     * *
* *    ** * * * * * *
* * * *   * * *   * *
* * * ** ** * ****  *
* * *     *   *     *
* * *****  ** * * * *
*       *       *   *
*********************
