*********************
*           *       *
*** * ****  * *** ***
*   *   *   *   *   *
*  * ** ******* *** *
*       *     *     *
*** * *** * *** *   *
*   *  P* *     * * *
* *** * * ***** *   *
*   * *   *   *     *
* * ***** **    *** *
* *     *     *     *
* ***** * ***** *** *
*   *   * *   *     *
***   *** * * *** * *
*   *     * *     * *
* * ***  ** ******* *
* *     *   * *     *
* ****  *  **   * * *
*         *      G  *
*********************
