*********************
*       *           *
*** *****   * ***** *
*  G*   *     *   * *
* *** * *** * * * * *
*     *   * *   *   *
* ******  *   *******
*     * * * * *     *
***** * * * * * *** *
*   *   *   *     * *
***  **  ******* ** *
*     *       *   * *
*  **** * *** * * * *
*       *   *       *
* **** **** * * *** *
*   *P  *       * * *
*** * * * *** *   * *
* *   * *   *   *   *
* * *** *** ******* *
*                   *
*********************
