*********************
*         *         *
*** * *** *** *  ** *
*     *       *   * *
* ************ *  * *
*               *   *
********* * **  * * *
*   *     *       * *
*   * ** ** *   *** *
* * *   * *   *     *
* ******  * *********
*     *     *       *
*  ** * **********  *
* * *             * *
* * ** ****** **  * *
*  G      *       * *
***   * * * *** * * *
*   *   *   * *   * *
* ***** ***** *** * *
*       *          P*
*********************
