*********************
*     *     *    G  *
* * **  * * * *******
* *   * * * *       *
*  ** * * *  ****** *
* * *   * *         *
* * ***** *  ** *   *
*   * *     *     * *
* * * * *     *** ***
* * * * * *   * *   *
*   * * *** *** * * *
* * *P*   * *     * *
* * * *** * * *** * *
*         * *     * *
* * **  * * * * *** *
*       *   *   *   *
* * ***** ***** * ***
*     * *       *   *
***** * ***** *  ** *
*           *       *
*********************
