*********************
*     *     *      P*
* *** * **  *   *** *
*   *   * * * *   * *
***  ** * * * *** * *
*   *     * * *   * *
* *** ***** *    ** *
*   * *   *   *   * *
* * *   * *** * * * *
* *   * *     *   * *
*  * ** * * *  **  **
* * *   *   *  G*   *
* * * *** *  ** * * *
* * * *   *   *   * *
* * *******   ***   *
* *     *   * * *   *
* * *** *  ** * *** *
*     * * * *       *
***** * * * *** * * *
*                 * *
*********************
