*********************
*           *G      *
* ***  **** * ***** *
*   *     *       * *
*   * * *** ******* *
*     *   *         *
* *****   ******  * *
*     * *       *   *
***** *   **  ***** *
*     * *     *   * *
* ******* * *** * * *
*       * *         *
* *** *  **** ** ** *
* *   * *         * *
* * * * *  ****** * *
*     *   *     * * *
***** * ******* * * *
*     *     *   *   *
*   * *** * * ***** *
*  P      * *       *
*********************
