*********************
*                   *
* ***** *********** *
*     *     *     *P*
***** * * * * *** * *
*   * * *         * *
* * * * *  ** * *** *
* *G* *   *   *     *
* * *  **** ******* *
* * * *   * *     * *
* *   * *   * * * * *
* *   * * *   *   * *
******* *   *** *****
*     * * * *       *
****  * * * * ***** *
*   *   * *       * *
* ******* * ******  *
*   *   * * *   *   *
* * * * *  ** * * * *
* *   *       *     *
*********************
