*********************
*             *     *
* **** ****** ***** *
* *           * *   *
* * ********  * * ***
* *             *   *
* ** **** * *** *** *
*   *     *   *     *
**  * * *** * **  * *
*     *   * *    G* *
********* **** **** *
*   *     *         *
* *   *** * *********
* *   *     *       *
* ** **  ** * ***** *
*   *     * * *     *
*   ***   * * *  ** *
* *   *   * * *     *
* **  ***** * * *** *
*             *  P  *
*********************
