*********************
*                P  *
* ******* *** * * * *
*     *     * * *   *
***** * **    * *** *
*     *   * *       *
* ** * ** *  **** * *
*   * *   *     *   *
*** * *   * *** *   *
*   * *   *   *     *
* *** * * *   * * * *
*   *   *G*   *   * *
* *  **** * * *** * *
* * *     * *   * * *
**  * ***** *** * * *
*   *     *   * * * *
* **  *   *** * * * *
*   * *     *   * * *
* * * *  ** * * * * *
* *   *       *     *
*********************
