*********************
*G                  *
* ** **    **** *** *
* *   *           * *
*   * ******** **** *
* *     *   *  P    *
* * *  ** *** *** * *
*   * *   *   *   * *
*****   ***  *  *** *
*           *   *   *
* ***  ** *** ***** *
* *       *       * *
* *** ***  ** *** * *
*   *   *     *     *
*** ******* * * *** *
* *     *   * *     *
* ****  * * * * ** **
*           * * *   *
* * *** * * *   * * *
* *           *   * *
*********************
