*********************
* *                 *
*   *** *** * *** ***
*   *       *       *
* ***  **** ******* *
* *   *   * *   *   *
* * *   * * * * * * *
*   *   *   * * *  P*
****  ******* * *** *
*    G*       *     *
* ********* * ****  *
* *     *   * *   * *
* *** * * *** * *   *
*     *   *   *     *
* * *** ***  ** *****
*     * *   * *   * *
* ******* *** *** * *
* *     * * *   *   *
* *  ** * * *   * * *
*   *     *   *     *
*********************
