*********************
*   *             * *
* * * * * * * * * * *
* * * *     * * *   *
* * *** *** * * *** *
* *   *   * *G* *   *
*  *  *** * ***   ***
*   *     *         *
* * ** ** **  * *** *
* *   *       * *   *
* *** * *** * * * * *
*   * * *   * * * * *
* *** * ***** *** * *
*   *               *
**  **  * * ******* *
*       *       *   *
* *** * * ** ** * ***
*    P* * * *   *   *
* * * * * * * ***** *
*   *       *       *
*********************
