*********************
*      G            *
* ********* ******* *
* *       *     * * *
*   ***** *  ** * * *
* * *   * *   * *   *
* * * * * *** * * * *
*   * * *     * *   *
* * *** ******* *** *
* *   *     *   * * *
*  ** *** ***  **   *
*   *   *   *       *
* ***** ***    *** **
* *   *     *   *   *
* * * ** **  ** * * *
*P  *     *   *   * *
* ****    * ******* *
* *     * * *   *   *
* *   *   *     * * *
*   *   *   *     * *
*********************
