*********************
*         *    P    *
* * * * * * *** *** *
*     * * *   * * * *
******* ***** * * * *
*     * *     * *   *
* *** * * ***** **  *
* *   *   *   *   * *
*   * *****   * * * *
* * *   *   * * *   *
* * *   * *** * * * *
*     * * *  G    * *
* *** * *  ***    * *
* *   * *     *   * *
* * **  ***** * *** *
* *           *     *
* * *  ************ *
* *     *     *   * *
* * *   * *** * * * *
*     *     * * *   *
*********************
