*********************
*                   *
*  *  ******* * **  *
* *   *   *  G*     *
* * *** * * *** * * *
* * *           * * *
* *   * ****  *** * *
* * * *           * *
*   * * ***** ** ** *
*   * * *     * *   *
***   * *  **** * ***
*   *   *       *   *
* ** ** * ** * **** *
*     *   *   *     *
* *** *    ** * * * *
*   *   * *   * *   *
* * * **  * *** * ***
*   *   * *  P* *   *
* * ***** * * * *** *
* *         *   *   *
*********************
