*********************
*         *     *   *
* *** *** * * * * * *
* *     *   * * * * *
* * ********* * * * *
*     *       * *   *
* ***** *** * ***   *
* *     *G    *   * *
*** * *** ****  *** *
*   *   * *   * * * *
* *** * **  *  ** * *
*     *   * *     * *
* *** ***   *** *** *
* *     *   *   *   *
* ** ** ***** * * ***
*         *   *   * *
******* * *** ***** *
*         *   *     *
* * * *****   * *** *
* *         *      P*
*********************
