*********************
*       *     *     *
* *  **  ** * * *  **
*   *       * * *   *
* * *********** * * *
*   *           *   *
* ***  ** *  *  * ***
* *   *P*   * *   * *
* * *** ***** ** *  *
*   *               *
* *  ******   **  * *
* *               * *
* ************* **  *
* *   *           * *
* * * *   ******* * *
* * * * * *     * * *
* * * * * * *** *** *
* *     *   *   *   *
* * *****  **   * ***
*           *      G*
*********************
