*********************
*     *             *
* *** * * * **** ** *
* *   *   *     *   *
* * **  * *** * * ***
* *  P  * *   * *   *
* *** *   *  ** *****
* *   * * *         *
* *  * ** * * * **  *
* *       * * *   * *
* *** ***** * *** * *
*   *       *     * *
*** * * *** *  ***  *
*     *     * *     *
* *    ** *** * *** *
* *     * *   *   * *
* *** *** * * **  * *
*G  * *   *   *   * *
*** *** *  ** * *** *
*       *   *       *
*********************
