*********************
*                   *
* * * * *** * *** * *
*   *   *   * *     *
* ******* * *   *****
*   *     * * *     *
* * * ***** * * *** *
* *     *  G*     * *
* ** ***  *** * **  *
*   *   *     * *   *
***** * *** *** * ***
*     *   *   *     *
*  *****    * **** **
*     * * * * *     *
* *** *  **** * * * *
*   *       *   *   *
* ***** * * *** *   *
* *       *P  *   * *
* * ***  * ** * *** *
*               *   *
*********************
