*********************
* *           *     *
* * ***** * * * *  **
* * *   *     * *   *
* *   * *****   *** *
*   * *     *   *   *
* **  ***** * **  ***
*   * *   *     *   *
*** * *** * * ***** *
*P  *   * * * *   * *
* ***** * * *** *   *
* *       *  G  * * *
* * *** *   * *   * *
* *   * *   * * * * *
* *** * **  * * * * *
*     * *   *   *   *
* *** * *  *** ** * *
* *   * *     *   * *
* *** * * * *** *** *
*   *   * *         *
*********************
