*********************
*       *       *   *
* ****  *  ** * *** *
* *   *       * *  G*
* * * ** * **** * ***
* * *         *     *
* *  ***** ***  *** *
* *     *       *   *
* ** **   **** **  **
* *   *     *   *   *
* ***  **** * * * * *
*   *     *   *   * *
*** *** * * ***** * *
* *   * *       * * *
* *** * ***** *   * *
*     *   *       * *
*  * * ** * *   * * *
*       * * * *   * *
**** *   ** *  **** *
*P          *       *
*********************
