*********************
*     *       *     *
*** * * * *   * *** *
*   *    G*   * *   *
* *** ***   * *** * *
*   *   * *   *   * *
* * *** * *** * **  *
* *     *   *   *   *
* ******* * ** ** ***
*       *   *     * *
******* * ** * ** * *
*       * *         *
* * * *** * *********
* *     * *         *
* *** * * * *** **  *
* * *     *     *   *
* *    ** ******* ***
*   *     *     *   *
**  ***** * *** *** *
*       *  P  *     *
*********************
