*********************
*     *             *
* *** ***** * * * * *
*   * *     * * * * *
* *** * *** * * * ***
*   * *   *   * *   *
***   * *  ** ** ** *
*   * * *   * *     *
* *** * *** * * *****
*    G* *   *       *
* ***** * *** ***** *
*         *     *   *
* ***** * *****   * *
* *   * *   *     * *
* * *  **** * ***** *
* * * *   *   *   * *
* * * * * *** * *** *
* * * * *   * *   * *
*   * * *** * * * * *
*       *    P*     *
*********************
