*********************
*       *     *     *
* ***    **** * * ***
*     *     *   *   *
*** ******* * ****  *
*   * *P    * *     *
* ***   *   * * *** *
*     * *   *   * * *
******* ****  *** * *
*   * *       *   * *
* * * * *******   * *
* *   *   *   * *   *
* *** * * * * * *****
* *     *     * *   *
* **** ******** * * *
*   *           * * *
* * * ********** ** *
* *   *     *   *   *
* ***** **    * *   *
*       *     *G    *
*********************
