*********************
*     *            P*
*  ** *  ** ******* *
* *   *     *   *   *
* *** *** *** *** ***
*     *       *   * *
* * * * *** *   *** *
* * * * *   * * *   *
*** * * *****   *   *
*       *     *   * *
* ******  ** ** * * *
*     *     *     * *
*  **  **** * **** **
*   *  G  *     *   *
*** ***** ******* * *
*   *   *         * *
* **  * * ******* * *
* *   *       *     *
* * * * *** *** *** *
*   *       *   *   *
*********************
