*********************
*             * *   *
* *** *** *** * * * *
* *             * * *
* *  *** ** ***** * *
*   *             * *
*   *** **** *  *** *
*     * *       *  G*
* **  *** * *  ** * *
*   * *   *   * * * *
*** * * *******   * *
*   *           * * *
*  **** ** **** *  **
* *   *       * *   *
* * * * ***** * **  *
* * *   * * *   *   *
* * * *** * * * * * *
*   *       * *   * *
* * **  *** * *** * *
*  P                *
*********************
