*********************
* *   *         *   *
*   * * ******* * ***
*   *   *     * *   *
* * *******    **** *
*   *       *   *   *
*** * * * * ***   * *
* *   *       *   * *
* **** **** * *** * *
*     *       *     *
* **      * * *  *  *
* *   * * *   *     *
* * *** * *** ** *  *
* *     * *     *   *
*  **** * ******  ***
*     *   *       * *
***** * *** ******* *
*  G  *   *   *     *
* * ***** *** ***** *
*                  P*
*********************
