*********************
*     *             *
*   * * ***** ***** *
* * *       * *   * *
* * * *****   *   * *
* *           *   * *
* ******* ***     * *
*G*     *       *   *
* * * * * * ******* *
*   * * *         * *
***  **  ******** ***
* * *   *       *P  *
* *   * * ** ****   *
* * * *   *     * * *
* * * * * ***** * * *
* * *   * *     * * *
* * *** * * *  **** *
* * *               *
* *   * * *** *** ***
*                   *
*********************
