*********************
*   *       *       *
* * *** * * * *   ***
* *       * *  P    *
* ********* ******* *
* * *     *         *
* *   * *********** *
*     * *       *   *
* ***** * *****   ***
*     * *     *   * *
***** * * * * * *   *
*     *     * * *   *
* ** **   * * * *** *
*G    *   * * *     *
* *** * * * *  ******
*     * *   * *     *
**    * *** * * *****
*   * *             *
* *** *** * * ***** *
*   *   * *         *
*********************
