*********************
*   *               *
*   * * * * *****   *
*   * *   * *     * *
*   * * * * * * * * *
* *   *     *P  * * *
* ******    *** *** *
*         * *   *   *
**** **** * * *** ***
*G  *       *     * *
* * * ****  *** *   *
* * * * *   *   * * *
* *** * * * * * *** *
* *   * * * * *     *
*   *** * *** * *****
*   *   *     *     *
*   * * *** * * *** *
*     *   * *     * *
*  *  * * * ***** * *
*     *   *         *
*********************
