*********************
* *   *         *   *
* * * * * *  ** * * *
*   * * * *  P* * * *
* *** * * * * * **  *
*   *   * * * *     *
*** ****    * ***** *
*G                  *
*** *** **   ********
*     * * *     *   *
* **  * * ***   * * *
* *     *     * * * *
* ********* * * *** *
*         * *       *
********* ******* * *
*       *     * *   *
* ***** ******* * ***
*               *   *
***** ********* * * *
*             *     *
*********************
