*********************
* *         *       *
* * * ******* *** * *
*  G* *     * *   * *
* *** * * * * *  ** *
*     *   *   *   * *
*** * **   **  ** ***
* * *     *     *   *
* * ******* ** **** *
*   *     *     *   *
* * * *** ****  * ***
*   *   *     * *   *
*  ** * ***** *     *
*     * *   *     * *
*** * * *** *****  **
* * *     *     *   *
* * ****  **  * * * *
*   *   *    P*   * *
* * * * *** * * *** *
*           * *     *
*********************
