*********************
*P      *         * *
*  ***  ***  ** * * *
*     *     *   *   *
*   * * * * *  **** *
* *       *     *   *
* *  **** * *** *** *
* * *     *   * * * *
* * * * * *** * * * *
* *   *   *   *     *
* * *** *** **  *** *
*G*   * *   *     * *
* * * * * *** * *** *
*     *       * *   *
******* *** ***** ***
*       *   *   *   *
* * *** ***** * *   *
*     * *   *   *   *
* * * **  * * * *  **
*   *         *     *
*********************
