*********************
* *             *   *
* * * ******* * * * *
*     *       *   * *
* ***** *** * *** * *
* *   * *   * *     *
* * * * * ***    ** *
* *     * *       * *
*** ***** **** *  * *
*               *   *
* *** ******* * *** *
*         *       * *
*** * * *** * * *   *
*   * *     *G* * * *
* *  ****  ** * * * *
* *       *   *   * *
* **  ***   *** * * *
* *   *   * *   *   *
* * *** ***   * *** *
*P                  *
*********************
