*********************
* *           *     *
* *  * **** * * * ***
*         * * * *   *
* *** ***  *  * *** *
*   *   *   *     * *
*** *** *** ******* *
* * * * *         * *
* * * * **  ***** * *
* * * *  G      *   *
* * * ***************
* *   *             *
* *** * *   * *******
*       * *         *
* * *** ******  *   *
*     *           * *
* *** ** * * **** * *
* * *   *       * * *
* * *** *  **** * * *
*     *    P  *     *
*********************
