*********************
*                   *
* ******* * ****  * *
*     *     *       *
* *** *******  **** *
* * *   *   * *   * *
* * *** * * *** * * *
* *   *G* *     *   *
* * *** * ***   *****
*     *   * * * *   *
* * * ***** * *     *
* * *           *   *
* ***** ****   **   *
*     *           * *
** ** * * *** ***** *
*   * *         *   *
*** * * ********* ***
*   * *         *   *
* **  *** *** * * * *
*P        *         *
*********************
