*********************
*       *           *
*** *** *  ****  ****
*   *               *
* * * ***** * ***** *
*   * *     *     * *
* * * * *** * ***** *
* *G*   * * * *     *
*** *****   * * *** *
*           * * *   *
* * * ** ** * *  ****
*   *       * *     *
* * *   ***   ***** *
* * * *   *         *
*   * *** * * * * * *
* * * *   *     * * *
* *  *   **** * *** *
*   *    P    * *   *
*  **  **** * * * ***
*           * *     *
*********************
