*********************
*   *   *    P      *
* * * * * ****  *** *
* *   * *     *   * *
* ***** ***** *** * *
*     *     *     * *
* *** ****  * * * ***
*   * *   *   * *   *
*** * ***  * *  * * *
* * *   *     *   * *
* * * ******* *** * *
*   *   *     *     *
* ** ** * *** *  ****
*       * *       * *
** **** *  ****   * *
*   *   *       *G* *
* * * **** * **     *
*   * *     *     * *
* * *  ** * *  * ** *
* *       *         *
*********************
