*********************
*           *G      *
* * ******* * ***** *
*   *   *   * *   * *
* *   * ******* * * *
* * *         * *   *
* * * * * *** *  * **
* *   *     *   *   *
* *** *  ** ******* *
*     *   *       * *
****  *   **** ** * *
*   * *P* *     * * *
* * * *** * *** * * *
*   *   * *   *     *
* * **  * *** ****  *
* *   * * *   *     *
* * * *   * * * *****
*   *   * *     *   *
* ******* * * *   * *
*         * *     * *
*********************
