*********************
*     *          G* *
* *** * **** **** * *
* * *   *           *
* *   * * *  ****** *
* *     * *   *     *
* * ***** * * * * * *
* *   *     *   * * *
* * * * ** ****** * *
* * * *         * * *
* *   * ******* * ***
* * *           *   *
* ***** * *** ***** *
*     * *     *     *
*** * ***** * * *****
*     *     *       *
* ****   **** ** ** *
*   *   *   * *   * *
* * * *** * * * * * *
* *       *  P  *   *
*********************
