*********************
*       *   *       *
*   **  *   * * *** *
* * *     *   *  P  *
* * *************** *
* *   *   *       * *
****    * * * ***** *
*     * *   *       *
*   * * ***** *******
* *     *   *       *
* ******* * ******* *
*         * *       *
* ****** ** * *******
*     *   *   *     *
* *** * * ******  * *
*     * *   *     * *
* *****       * * * *
*    G  * *     * * *
**  ****   ****** * *
*                   *
*********************
