*********************
*         *         *
* * * *** * **** ** *
* * * *   *   *  P* *
* ***   * *** *   * *
*     *   *   *   * *
* *********  ** * * *
*   *   *       *   *
*** **  * * ***** ***
* * *     *       * *
* *    ** *  *  * * *
*   *     * *   *   *
* **  * *** * ** ** *
* *  G  *   *     * *
*  **** *** ***** * *
*           *   * * *
***** ** *  * *** * *
*     *       *   * *
* *** *    **** **  *
*       *       *   *
*********************
