*********************
*                 * *
* ***** * ******  * *
*     * *   *  G* * *
* *** * * * * *** * *
*       * *       * *
*** *****   * * *** *
*   *   *   *   *   *
* * * *  ** * ***** *
*     * *   *     * *
*    *  *  ****** * *
* *   * * *       * *
* *** * * * ** **   *
*     *   * *       *
***** *****   *  ** *
*     *   *   *P    *
*  *  *   *** * * * *
* * *   *   *     * *
* * ******* ** ***  *
*                   *
*********************
