*********************
*                   *
* * *******   ***   *
* *         *   * * *
* ****   ** *** *** *
*   *     *   *   *G*
***    ** *   *** * *
*   * * * * * * *   *
* * * * * * * * * * *
*   * *   *   *     *
* *** * *** ** **  **
* * * *   *         *
* * *  ** * ******* *
* * *   * *     *   *
* * * * * ****  * ***
*   * * * *     *   *
* * *   * ********* *
* * *   *   *P      *
*   * *** * * *** * *
* *   *       *     *
*********************
