*********************
*G*       *         *
* *  **** *** * *****
* *     *     * *   *
*  ** *  ** * *** * *
*     * * * *     * *
***   * *   ***** * *
*   *   *   *   * * *
*  **  ** *** * * * *
* *           *     *
*   ************* * *
* * *       * *  P* *
* * * * * * * * *** *
* *   * *   *   *   *
* ****  * ***  ** * *
*       *   * *   * *
* ***** * * * ***   *
* *         * *   * *
* ***** ** *  *  ** *
*               *   *
*********************
