*********************
*         *    G  * *
*   **  * ****  * * *
* * *   *   *   *   *
* *  ** *** *   *** *
* * *   *       * * *
* * *  ** ***** * * *
* *   *   *     *   *
*** * * *** ***** * *
*   *         * *   *
* ****  ***** * *** *
*     *             *
* *** * ******* * ***
*P*   * *     *     *
* * *** *  ** *******
* * *   * * *       *
*** * *** * *********
*         *   *     *
* ******* * * *  ** *
*           *       *
*********************
