*********************
*           *    G  *
* ****  ***   *** * *
*   *   * * *     * *
***   * * * ***** * *
* *   *       *     *
* ** ** * *   ***** *
* *     *   *     * *
* * **  ** ****** * *
*   * *         * * *
* *** ***** *** * * *
*             *   * *
***** * ***** ** ** *
*           * *     *
* * ***** * * * * * *
* *         *   * * *
* * *** *****  ** * *
* * *   *         * *
* * * *   *** *** * *
*   *       *P      *
*********************
