*********************
* *   *       *     *
* * *  *  *   ***** *
* * *   * * *       *
* * *** *** ** **** *
*   * * *   *     * *
*   * * * ***   *** *
* *   * *     *     *
* * * * * * *** * ***
*     *   * * * * * *
* * **  *** *   *   *
* *     *   *   *   *
*  *****  *    **** *
* *       *      G* *
* * * * * * * ***** *
*     *     * *   * *
***** *  **   * * * *
*     * * *   * * * *
* ** ** * * *** * * *
*P        *     *   *
*********************
