*********************
*           *       *
**** **   * * *  ** *
*       * * *     * *
* *** * *   *** * ***
* * * * * *     *G  *
* * *  ** *** * *** *
*         *   *     *
* *** ***** ***** * *
*       * *   *     *
* *** * * *** * * * *
*   *   *   * * *   *
****  ***** * *   * *
*     *     * *     *
*  ** *** * * *  ** *
*       * * * *   * *
* *** * * **  * *** *
*   * * * *   * *   *
* * *** *   **  * * *
* *  P  *         * *
*********************
