*********************
*          P        *
* ********* **** * **
*     *             *
* **  * ******* *** *
*   *   * *         *
***** * * * * *** * *
*     *   * *   * * *
* *** *** * *** * * *
* * *     *   * * * *
* * * * ***** * **  *
*   *   *   * *   * *
*** *   *   * *** * *
* * *     *   *   * *
* *  ***** **** * * *
*   *     *G    *   *
* ***  ** * * ***** *
*   *   * *   *     *
**  *** * * * * *** *
*       *   *   *   *
*********************
