*********************
*           *       *
* *** * ***  **** * *
*   * * * * *   * * *
***** *   * * * * * *
*     *       * * * *
* *** *** ***** * ***
*   * *   *     *   *
*** *** *** * * *   *
* * *   *   *   *  P*
* * * *** * ***** * *
* *   *   * *       *
* ** *  *** ***** * *
* *   *     *     * *
* *      ****  **   *
*   * *     *   *   *
* **  ***** *** *** *
*   *     *   *   * *
*** * ******* *** * *
*   *        G    * *
*********************
