*********************
*             *     *
* ********* *** * ***
* *       *     *   *
* ***  **** * *** * *
*     *             *
* * *** * ***********
* *    P* *   * *  G*
* * *  **   * * * * *
* * * *   * *     * *
* * ***   * * ***** *
* *   * *   *       *
*  **   * * *** * * *
*   *   *   *   *   *
*** ******* *** *** *
*   *               *
*  **** ***** *** ***
*       *   *   *   *
* *** **  * *** *** *
*     *             *
*********************
