*********************
*   *     *   *     *
*  ** *   * *   *** *
*     * *   * *   * *
*   *** ** ** ** ** *
*       *   *P    * *
*   ***** * ***** * *
* * * *   * *   *   *
*   * * * ***    ** *
* * *   * *   *     *
*** * *** * ***** * *
*   *   * *   *     *
* ******* *** * *****
* *       *         *
*** * ****  *** *** *
* * *     * *   *   *
* * ***** * *** * ***
*       * *     *   *
* *** *   ******* * *
*     *    G        *
*********************
