*********************
*         *         *
* * ***** * ***** * *
*     * *     *   * *
* *** * * ***   * ***
*   * *     * *     *
***   ****  ******  *
* * *  G* *         *
* *  ** * ** *** ** *
* *   * *     *     *
* *   * **  * * *****
*     *   * *   *   *
* **** **   *** *** *
* *     * *         *
* * *  ** ***** ** **
* * * *   *   *     *
* * * * * * *  ***  *
*   *   * *    P    *
*** * * *** * *** * *
*     *         *   *
*********************
