*********************
*     *     *       *
* * * * *   * * **  *
* * *   * * * * * * *
* * ***** * * * * * *
*   *   * *   * *   *
* *** * *  *  *    **
*       *     * *   *
******   * * ** * ***
* *   *     *     * *
*   * ***** * * *** *
*G  *     * *     * *
* ** **   * ***** * *
* *     * *     *   *
***  ** ******* * ***
*   *   *     *P  * *
*  ** *** *** *** * *
*   * *   * *   *   *
* * *** *** ***  ** *
* *           *     *
*********************
