*********************
* *               * *
* * ***** * ****  * *
*   * *     * *   * *
* *** * * * *   *** *
*     * *        G  *
** ****   * ***** ***
*       * * * *     *
* ** ** * *     *** *
* * *     *   * *   *
* * * ***** * * * ***
*     *   * *   *   *
* ***** * * ***** * *
*       * *     * * *
* ******   **   *** *
* * *P  *   *   *   *
* * * *   * * *** * *
*   * *   * * *   * *
*** * **** ** * *** *
*   *           *   *
*********************
