*********************
*       *     * *   *
*** * * * *** * * * *
*   *     *     * * *
* ********  * ***   *
* *   *   *   *   * *
* * * *** * *** * * *
*   * *   * *   *   *
***** * *** * *** ***
*   * *     * * *   *
* * * * *****    ** *
* *   * *          G*
* ************* ** **
*P            * *   *
* **** * **** * * * *
*   *     * *   * * *
*** *   * * * ***** *
* *     * *         *
* *** * * ** ** *   *
*       *         * *
*********************
