*********************
*               *  G*
* *** ******* * *** *
*   *         *   * *
* * **  ** ** ***   *
* *           *     *
* *** *** *** **   **
*     *   *   *     *
* * * ***** * * **  *
* * *P      * *   * *
*** ***   ** *  * * *
*   *     *   *   * *
* ******* *   *** * *
*           *   *   *
*   ***** *** **  ***
*   *       *   * * *
* * * *** ***** * * *
*     *   *         *
** *  * *** ** *  * *
*         *         *
*********************
