*********************
*         *     *   *
* ******* * * * *** *
* *     * * * *  P* *
* *  **   * * *** * *
*     *   * * *     *
******* * * * * * * *
*       * * *       *
*  ******  **   * ***
* *         *       *
* * *** *** * * *** *
* *       *   *     *
*  ****** * * * *** *
*  G*   *         * *
* * * *   **  *** * *
* *   * *     *     *
*  **** * ***********
*     * * *         *
** ** * *** ******* *
*                 * *
*********************
