*********************
* *         *       *
* * ******  * ***** *
* * *     *G*     * *
* * * * * *  **** * *
* *     * * *   * * *
* ***** *** * * *** *
*       *   * * *   *
*** * **  *** *** ***
*   * * * *   *     *
* *** * * * * ****  *
*   *   *   *       *
* * *** *****   ** **
* *   *             *
* ***   * ********* *
* * *   * *     *  P*
* * ******* *** * * *
* *         *   * * *
* ***** * **  * * * *
*                 * *
*********************
