***********
*AAGAAAAAA*
*A***A*****
*AAA*AAAAA*
***A*****A*
*A*AAAAA*A*
*A*A*A*A*A*
*P*AAAAAAA*
*A*A**A****
*AAAAAAAAA*
***********
