*********
*A*AAAAA*
*A*A*A***
*AAAAAAP*
*A*****A*
*AAA*A*A*
***A*A***
*GAAAAAA*
*********
