*************
*AAAAA*AAAAA*
*A**AA****AA*
*AAAAG*AAA*A*
*A*A*A*A*A*A*
*A*AAA*AAA*A*
*A*A***A**AA*
*A*A*AAA*AAA*
*A*A*A***A*A*
*A*AAA*AAA*P*
*A*********A*
*AAAAAAAAAAA*
*************
