*****
*AAG*
*A*A*
*A*P*
*****
