***********
*AAA*GAAAA*
*A***A*A*A*
*A*AAA*A*A*
*A*A***A***
*AAA*AAAAA*
*AA****A*A*
*AAAAAAA*A*
*********A*
*AAPAAAAAA*
***********
