*********
*A*AAAAA*
*A*A*A*A*
*A*A*A*A*
*A*A*A*A*
*G*A*AAP*
*A*AA*AA*
*AAAAA*A*
*********
