*****
*GAA*
*A*A*
*A*P*
*****
