*********
*AAG*AAA*
*A*A*A*A*
*A*AAA*A*
*******A*
*AAAAP*A*
*****A*A*
*AAAAAAA*
*********
