*****
*GAA*
***A*
*PAA*
*****
