***********
*AAP*AAAAA*
*A*AAA***A*
*AAAAAAA*A*
*A*A*****A*
*AAA*AAAAA*
*A*A***AAA*
*A*AAGAAAA*
*A***A***A*
*AAAAA*AAA*
***********
