***********
*AAAAAAA*A*
*A*A*AAA*A*
*A*A*AAG*A*
*A*A*A*A*A*
*P*A*AAA*A*
*A*A*A*A*A*
*A*A*A*AAA*
*A*A*AA****
*AAA*AAAAA*
***********
