*************
*AAAAA*AAAAA*
*AA****A*A***
*AAAAAAAAAAA*
*A*********A*
*AAAAA*AAA*A*
*A***A*A*A*A*
*AAAAA*A*A*A*
*A*****A*A*A*
*AAGAA*A*A*A*
*****A*A*A*A*
*AAAAAAAAAAP*
*************
