***********
*AAAAAAAAA*
*A*A*A***A*
*A*A*A*PAA*
***A*A*A*A*
*AAA*AAA*A*
*AAA****AA*
*A*AAAAA*A*
***A***AAA*
*AAAAG*AAA*
***********
