*************
*AAAAAAPAAAA*
*A***A*A***A*
*AAA*A*A*AAA*
*AAA*A*A***A*
*A*AAA*AAAAA*
*A***A*A*A***
*AAAAA*G*AAA*
***A***A***A*
*A*A*AAAAAAA*
*A*A*A*****A*
*AAAAA*AAAAA*
*************
