*************
*AAA*AAA*AAA*
*A*A***A*A***
*G*AAAAAAPAA*
*A***AA**A*A*
*A*AAAAAAA*A*
*A*A*******A*
*A*AAA*AAAAA*
*A***A*A***A*
*AAA*A*A*A*A*
*A*A*A*AAA*A*
*A*AAAAA*AAA*
*************
