*********
*AAAAAAA*
*A***A*A*
*AAAAA*A*
*AA****A*
*GAAAAAA*
*A*A***A*
*AAA*AAP*
*********
