*********
*A*AAAAA*
*A*A*A*A*
*AAA*GAA*
***A***A*
*A*A*AAA*
*A**AA*A*
*AAPAA*A*
*********
