*************
*A*AAAAA*AAA*
*A*A*A*AAA***
*A*A*P*A*AAA*
*A*A*A*A***A*
*AAA*A*AAAAA*
*A***A**AAAA*
*AAA*AAAAA*A*
*A*A*A***A*A*
*A*A*AAA*G*A*
*AAAAAAAAA*A*
*A*AAA*AAA*A*
*************
