***********
*AAA*AAAAG*
*A***A***A*
*A*AAAAAAA*
*A*A***A*A*
*AAAAA*A*A*
*******A*A*
*AAAAAAA*A*
*****A*AAA*
*PAAAAAA*A*
***********
