*****
*AAP*
*A***
*AAG*
*****
