***********
*AAAAAAPAA*
*A**A**A*A*
*AAAAAAAAA*
*****A*A*A*
*AAAAA*AAA*
***A***A*A*
*A*A*GAA*A*
*A***A***A*
*AAAAA*AAA*
***********
