*************
*AAPAA*AAAAA*
*A***A*AA*AA*
*AAA*AAA*AAA*
***A***AAAAA*
*AAA*AAA*A*A*
*AA**A*AAAA**
*A*AAA*A*AAG*
*A*A***A**AA*
*A*A*AAA*A*A*
*A*A*AA**AA**
*AAA*AAAAAAA*
*************
