***********
*AAAAA*AAA*
*A***AA**A*
*G*A*A*AAA*
*A*A*A*A***
*A*A*A*AAA*
*AAA*AA**A*
*AAA*AAA*A*
***AA**A*A*
*AAAAAAPAA*
***********
