***********
*A*AAA*AAA*
*A*A***A*A*
*A*AAPAAAA*
*A**A**A*A*
*A*AAAAA*A*
*A*A***A*A*
*AAA*AAA*A*
*A***A***A*
*AAA*GAAAA*
***********
