***********
*AAA*AAA*A*
*A*A*A*A*A*
*AAA*A*AAP*
*A***A***A*
*A*AAA*AAA*
*AAA*****A*
*AAA*AAA*A*
*A**AA*A*A*
*AAAAA*AAG*
***********
