*********
*A*AAAAP*
*A*A***A*
*AAAAA*A*
*A**AA***
*A*AAAAA*
*A*****A*
*GAAAAAA*
*********
