*************
*A*AAPAAAAAA*
*A*A*******A*
*AAA*AAA*AAA*
*A*A*A*AAA*A*
*AAA*A*A*AAA*
*A*****AA**A*
*AAAAA*AAA*A*
*****A*A*A***
*A*AAA*A*AAA*
*A*A*****A*A*
*AAAAAAAAG*A*
*************
