***********
*AAAAAAPAA*
*A*******A*
*A*AAA*AAA*
*A*A***AA**
*A*AAAAAAA*
*A***A*A*A*
*AAA*AAA*A*
***A*A*A***
*AAAAA*AAG*
***********
