*********
*AAAAAAP*
*A*AA**A*
*A*A*AAA*
*A*A*A***
*A*A*AAA*
*A*AA****
*G*AAAAA*
*********
