*****
*AAP*
*A*A*
*A*G*
*****
