*************
*A*AAAAAAAAA*
*A*AAA***A*A*
*A*A*AAA*AAP*
*A*A**AAA****
*G*A*A*AAAAA*
*A*A*A*****A*
*AAA*AAAAA*A*
*A***A*****A*
*A*AAA*AAAAA*
*A**AA**A****
*AAAAAAAAAAA*
*************
