***********
*AAAAAAA*A*
*A*A***A*A*
*A*A*AAAAA*
***A*****A*
*G*AAAAA*A*
*AA****A*A*
*A*AAA*A*A*
*A*A*A*A*A*
*AAAAAAP*A*
***********
