*********
*AAAAAAA*
*A***A*A*
*PAAAA*A*
***A***A*
*AAA*AAA*
*A*AAA***
*GAA*AAA*
*********
