*****
*G*A*
*A*A*
*AAP*
*****
