***********
*AAAAA*A*A*
*A***A*A*A*
*AAA*AAAAA*
***AAAA**A*
*A*A*AAP*A*
*A*A*A*A*A*
*A*A*A*AAA*
*A*A*A*A*A*
*GAA*AAAAA*
***********
