*************
*AAAAPAA*AAA*
*A*A***A*A*A*
*A*A*AAA*A*A*
*A*AAA***A*A*
*A*A*A*AAA*A*
***A*A*AA**A*
*AAA*AAA*AAA*
*A******AA***
*GAAAA*AAA*A*
***AAAAA***A*
*AAA*AAAAAAA*
*************
