*****
*G  *
**  *
*  P*
*****
