***********
*A*AAA*AAP*
*A*A*A*A*A*
*AAGAAAAAA*
****AA**AA*
*AAAAAAAAA*
*A*****AAA*
*AAA*AAA*A*
*A*A*****A*
*AAAAAAAAA*
***********
