*********
*AAAAPAA*
*A**A**A*
*AAAAA*A*
*AA**A*A*
*A*AAG*A*
*A*****A*
*AAAAAAA*
*********
