*********************
* *      G          *
* * ***** **  *** * *
* *     * * * *     *
* ****    * * * *** *
*     * * *     *   *
* ***   * **** ** ***
* *   * *       *   *
* *   * ***  ** *** *
* * *   *     * * * *
* *** *** ***   * * *
* *             *   *
* * *** *  *  **** **
* * *       * *     *
* * * *  ** * *  ** *
* * * *   * * *   * *
* * **  ***  ** *** *
* *   *   * *       *
* *** ***   * *** ***
*         *     *  P*
*********************
