*****
*G  *
* ***
*  P*
*****
