***********
*PAAAAAAAG*
*A*A*****A*
*A*A*AAAAA*
*AAA*AA**A*
*AAA*AAA*A*
*A***A***A*
*A*AAA*AAA*
*AAA*A*AA**
*AAAAAAAAA*
***********
