*********************
* *             *   *
* * ******* **  * * *
* * * *         * * *
* * * * *** ***** * *
*   * *       *   * *
* * * ********* * ***
* *         *   *   *
* * **** ** * ** ** *
* *           *   *G*
*  **** ** ** * * * *
*     * *   *   * * *
*** * * *   * *  ** *
* *     * * *   *   *
* * *** * * *  ** * *
*       * * * *   * *
* **  * * *   * **  *
*     * * * * *   * *
* ******* *  * *  * *
*         *      P* *
*********************
