*********
*PAAAAAA*
*A*****A*
*AAAAA*A*
***A***A*
*GAAAAAA*
*A*A*****
*AAAAAAA*
*********
