*******************
*  G          *   *
* *** * * *   **  *
*     * *   *     *
****  * * ***** * *
*   * *           *
* * * ******* * * *
* * * *     * * * *
* * * * * *   * * *
*   * * *     *   *
* *   * **  *******
* *   *   * *     *
* * ****  * * *** *
*   *   * * *   * *
* ***  ** *** *** *
*         *   *   *
* ***** * * *** ***
*       *  P  *   *
*******************
