*****************
*       *       *
*  ** * * * *** *
*   * *   * *   *
*  ** *** ***   *
* *  G* * *   * *
*** *** * * *** *
*           * * *
* ****** **** * *
* *       * *   *
* * ** ** * * * *
*   * *   *     *
*****  ***  *** *
*         * *P  *
* ****  * * **  *
*       *       *
*****************
