*****************
*   *   *       *
*   * * * *** * *
* *   *      P  *
* * * ********* *
* *             *
* ***** ** ** * *
*  G*     *   * *
* * * *** * *** *
* * * *   *     *
* * * *****   ***
* *   *   *     *
* *** * ** ** * *
*           * * *
* * * ** ** * * *
*         *     *
*****************
