*******************
* *             * *
* * *** **   *    *
* * * *         * *
*   * * ********* *
*   * *       *   *
*  ** ****** ** * *
* *           *   *
* * * * * *** * * *
*   *   * *   * * *
* ***** * * *** * *
*     * * * *P  * *
***** * * * * * ***
* *   * * *   *   *
* * *** *  **  ** *
* *     *         *
* ***   * * * * * *
*G          *   * *
*******************
