***************
*G          * *
* * ***** * * *
* *       * * *
* ** ****** * *
*         *P  *
* ** **   *** *
* *     * *   *
* * * * * * ***
* * *     * * *
*  ********   *
*   *   *     *
* * *   * *** *
* *   *       *
***************
