*********************
*         *         *
* *  ** * ** ** * * *
*     * *     * *   *
*  **** ***** ***   *
* *  P*   * * *   * *
* * * *** * * * *** *
*   *     * *   * * *
* * * ***** * *** * *
* *   * *   *       *
* * * * * * * * *****
*   * *   * *   *   *
* * * *   * * *** * *
* * *   * *   *   * *
* * ***  *****  *** *
* *   *         * * *
* *   ** * ****** * *
*   * *      G      *
***** ***** * ***** *
*           *       *
*********************
