*********
*AAAAPAA*
***A*AAA*
*AAAAA*A*
*A***A*A*
*A*GAA*A*
*A***AAA*
*AAAAAAA*
*********
