*************
*AAP*AAA*AAA*
*A*A*A*A*A*A*
*A*AAA*AAA*A*
*A***A*A**AA*
*A*AAAAAAAAA*
*A*AA**A*AA**
*A*AAAAA*AAA*
*A*A*******A*
*AAAAAAAAA*A*
***A*A***A*A*
*AAGAAAA*AAA*
*************
