***************
*         *   *
* * * * * * ***
* *       *   *
*** *** * * * *
*  P*       * *
* ** **** * * *
* *       * * *
* * *****   * *
*         *G  *
****  ***** * *
*   *         *
* * *    * ** *
*             *
***************
