*************
*GAAAAAAAAAA*
***A***A***A*
*AAAAAAAAAAA*
*A*A*A*******
*A*A*AAA*AAA*
*A*A*AA**A*A*
*A*PAA*AAAAA*
*A*****A**AA*
*AAAAAAA*A*A*
*A*******AA**
*AAAAAAAAAAA*
*************
