*************
*GAAAAAA*AAP*
*A**AA***AAA*
*AAA*AAAAA*A*
*********A*A*
*AAAAAAAAAAA*
*A****AAAA*A*
*A*A*AAA*A*A*
*A*A*A***AAA*
*A*AAAAA*A*A*
*A***A*A*A*A*
*AAAAA*AAA*A*
*************
