***********
*AAAAAAPAA*
*A***A***A*
*G*AAAAA*A*
*A*A**AA*A*
*A*A*AAAAA*
*A*AA*A**A*
*AAA*AAAAA*
*****AAA***
*AAAAAAAAA*
***********
