*********
*AAA*AAA*
*A***A*A*
*A*PAA*A*
*A*A***A*
*AAA*A*A*
*A*A*A***
*AAAAAAG*
*********
