***************
*             *
*  ****** *** *
*P*     * *   *
*   * *   * ***
*   *     *   *
* *  **  ******
* *   * *G    *
* *** * * *** *
*   * * *     *
*** * *** *** *
* * * *   *   *
* * * * * * ***
*         *   *
***************
