*****
*G* *
*   *
*  P*
*****
