*****
* *P*
* * *
*G  *
*****
