*****
* *P*
*   *
*G  *
*****
