*****
*P  *
*** *
*  G*
*****
