*****
*  P*
*   *
*  G*
*****
