*****
*  P*
*** *
*G  *
*****
