*****
*  P*
**  *
*  G*
*****
