*****
*  G*
* * *
* *P*
*****
