*****
*  G*
*   *
*P* *
*****
