*****
*P  *
**  *
*  G*
*****
