*****
*P  *
* ***
*G  *
*****
