*****
*G  *
* * *
*P  *
*****
