*****
*  G*
* ***
*P  *
*****
