*****
*  G*
*  **
*  P*
*****
