*****
*G  *
*   *
*P* *
*****
