*****
*P  *
* * *
*G* *
*****
