*****
*P* *
* * *
*  G*
*****
