*****
*  P*
* * *
*  G*
*****
