*****
*P  *
*  **
*  G*
*****
