*****
*G  *
*** *
*  P*
*****
