*****
*  G*
*** *
*P  *
*****
