*****
*P  *
* * *
*G  *
*****
