*****
*P  *
* ***
*  G*
*****
