*****
*G  *
* * *
*  P*
*****
