*****
*P* *
*   *
*  G*
*****
