*****
*  G*
* * *
*P* *
*****
