*****
*  P*
*  **
*  G*
*****
