*****
*G  *
*   *
*P  *
*****
