*****
*P* *
* * *
*G  *
*****
