*****
*P  *
* * *
*  G*
*****
