*****
*  G*
**  *
*  P*
*****
