*****
*  P*
* * *
* *G*
*****
