*****
*G  *
* * *
*P* *
*****
