*****
* *G*
*   *
*P  *
*****
