*****
*  G*
* * *
*P  *
*****
