*****
*  G*
* * *
*  P*
*****
