*****
*G  *
* * *
* *P*
*****
