*****
*  P*
* * *
*G* *
*****
