*****
*  G*
*  **
*P  *
*****
