*****
*G  *
*   *
*  P*
*****
