*****
*  P*
*** *
*  G*
*****
