*****
*G  *
* ***
*P  *
*****
