*****
*  P*
**  *
*G  *
*****
