*****
*G* *
* * *
*P  *
*****
