*****
*P  *
*  **
*G  *
*****
