*****
*  P*
* ***
*G  *
*****
