*****
*  P*
* ***
*  G*
*****
