*****
*P  *
* * *
* *G*
*****
