*****
*  G*
* ***
*  P*
*****
