*****
* *P*
* * *
*  G*
*****
