*******
*    P*
* *** *
* *   *
*   * *
*G    *
*******
