*******
*   *P*
*   * *
*G    *
***** *
*     *
*******
