*******
*P    *
* *** *
*   * *
* *   *
* *  G*
*******
