*******
*G    *
* * * *
*     *
* *** *
* *P  *
*******
