*******
*    G*
*** * *
*   * *
* * * *
*    P*
*******
