*******
*     *
***** *
*G  *P*
* * * *
* *   *
*******
