*******
*  G  *
* *** *
*   * *
*** ***
*    P*
*******
