*******
*P  * *
* * * *
* * *G*
* **  *
*     *
*******
