*******
*P  * *
*** * *
*   * *
* * * *
*G    *
*******
