*******
*     *
* *** *
* * * *
* *   *
*P*  G*
*******
