*******
*     *
**  ***
*P  * *
*  ** *
*    G*
*******
