*******
*     *
* *  **
* * *P*
* **  *
*G    *
*******
