*******
*  P  *
***** *
*   * *
* *** *
*G    *
*******
