*******
*     *
*** * *
*G*   *
* * ***
*    P*
*******
