*******
*    P*
*   * *
*   * *
* *** *
*G    *
*******
