*******
*  P  *
*  ** *
* *   *
* * * *
*  G* *
*******
