*******
*P   G*
* *** *
*   * *
* * * *
* *   *
*******
