*******
*    P*
*  ** *
* *   *
*** * *
*  G  *
*******
