*******
*  G* *
* *** *
*     *
* *****
*P    *
*******
