*******
*    G*
* * ***
* *   *
* *****
*P    *
*******
