*****************
*       *       *
* * **  * ****  *
*P* *   * *     *
*   *** * *  ****
* *   * * *     *
***** *** **  * *
*     *   * * * *
* ***** **  * * *
*           *   *
* ** *** ** * * *
* *    G*       *
* * * * ** **** *
*     *         *
* *** ***** *** *
*               *
*****************
