*****************
*     *         *
* *** *** * *** *
*   *     * *  G*
*   ***  *  * * *
*   * *     *   *
* * * * ***** * *
*   *         * *
*  ** ***** *** *
*               *
* *   *   * *  **
*   *           *
*** * ***  **** *
* * * *  P      *
* * * *****  ** *
*           *   *
*****************
