*****************
*     *        P*
* * * ***  * ** *
* * *     *     *
* * * *** *******
* * *           *
* * * ********* *
* * *   *     * *
* * **   **** * *
* *       *   * *
**** * ** * *** *
*       *G      *
* ***** *** *   *
* *   *     * * *
* *** ** ***  * *
*               *
*****************
