*****************
*     *     *   *
* *   * *** * * *
* *   * * * * * *
* *** *** *  ** *
*   *G      *   *
*** * *** *** * *
*   *     *   * *
* ***** *** * * *
*       *   * * *
*   ** **** * * *
* * *         * *
* * * *** ***** *
*   *   *       *
* ***** * * *   *
*      P* *     *
*****************
