*****************
*         *     *
* ****  * ***** *
*             * *
* * ********  * *
*   *    G  *   *
*   * *  * **** *
* * *     *     *
***   **  * *****
*   *   * *   * *
* ***** * *** * *
* *   * *       *
***     ******* *
*   *P  *     * *
*  **  **   * * *
*         *     *
*****************
