*****************
*G        *     *
*   * * * * * ***
* *   * * * *   *
*****   * * *** *
*     * *       *
* ***** * *** * *
* *   * *       *
*  ** *   ***** *
* *     *   *   *
*   * *  ** * * *
* * * *     *   *
*** *********   *
*     *P    *   *
* *** *  ** * * *
*   *     *     *
*****************
