*****************
*       *       *
* *** *** *  ** *
*   * *  P* *   *
* * * * *** * * *
*     *         *
* ***   * * *****
*   * * *     * *
*** * * *** * * *
*   * *     * * *
* * * *** **    *
*           *   *
* ***** *   *** *
* *     *   *G  *
* * ********* ***
* *             *
*****************
