*****************
* *  P*         *
* * *   *** * * *
*     *     * * *
*****   *  *  * *
*   *   * *     *
*   * *** * *****
* *       * *   *
*   **** ** * * *
* *    G      * *
*   ********* * *
* *       *     *
* * * * * * *****
* * * *         *
* *** * *********
*               *
*****************
