*****************
*           *   *
* *** *** * * * *
*         *   * *
*** ** ******** *
*     *         *
*****   *** **  *
*  G*     * *   *
* *  ** *   * ***
*     * *   *   *
*   *   * *** * *
* *       *   * *
* *  ****** *** *
* *         *   *
* *   *** * *   *
*P      *     * *
*****************
