*****************
*  P  *     *   *
*   * *   * *   *
* * *     *   * *
* * **** * **** *
* *   *   *     *
*  ** *** ***** *
*       *     * *
* ***** * *** * *
* *           * *
* * **  * *** * *
* * *   * *     *
* * ***** ***  **
* *     *G      *
* *****  * **** *
*     *         *
*****************
