*****************
*       *       *
* * ***   ***** *
* *   * * *   * *
* *** * * * * * *
* *   *   * *  P*
*** * *** *  ****
*   *       *   *
* *** ***** *   *
*   * *   * * * *
*** ***** * * * *
*   *       *   *
* **  ***** **  *
* *   *   *     *
*     * * ** ** *
*       *      G*
*****************
