*****************
*   *         * *
* *   * *** * * *
* *     *   *   *
* *** * * *  *  *
* *   * * *G    *
* **  * * ***   *
*   *   * *   * *
*** * *** * * * *
*   * *   *     *
* * ***   *** * *
* *     *     * *
* * **  * * * * *
* * *   *   * * *
* * *** * ***** *
*    P  *       *
*****************
