*****************
*             * *
* *** *****     *
*   *       * * *
* * * *** * * * *
* * *G    *   * *
*   * **  * * * *
*   * *     *   *
*** * *** *******
* * *   * *     *
*   *** *   * * *
* * * * * *     *
* * * *   * *** *
* *   * *  P*   *
* *** *   *** ***
*     *     *   *
*****************
