*****************
*       *   *   *
*** **  *   *** *
*   *   * *P    *
* *** **  * *****
* *       *     *
*  * ****** **  *
*         * * * *
* **** ** * * * *
*     *       * *
*** * * * **    *
*     *G    *   *
* *** ***** * ***
*   *   *   * * *
* * **    *** * *
*       *       *
*****************
