*****************
*   *   *     * *
* *   * * * * * *
* *  P*   * *   *
* * *** * * *****
* *   *   *     *
* **  ** **  ** *
*   *   * *   * *
*** * *** *** * *
* *           * *
* * * * ***** * *
*     * *     * *
* * *** * *** * *
*   *        G  *
*** * * *** **  *
*   *       *   *
*****************
