*****************
*           *   *
*   *  **** *** *
*G      *       *
* * * * ******* *
*     *     *P  *
***** * **  *** *
*   * *   *     *
* *** * * *  ** *
*       * *   * *
******  * *** * *
*     * * *   * *
***** * *  **** *
*   *   * *   * *
* * *****   * * *
*               *
*****************
