*****************
*   *   *       *
* * * * ***** * *
*     *       * *
* ****** ** *** *
*     *     *   *
* *** *** *** ***
*   *           *
****  * * * *** *
*   * *   *     *
* * *** *** * ***
*G*     *   * * *
* ******* *** * *
*       *  P    *
* **** *  *   * *
*         *     *
*****************
