*****************
*     *         *
*** *   *** *** *
*   *       *G  *
* ***** * * *** *
*   *   * *   * *
* * * *** *** * *
* * *   *   * * *
* * * ** ** *  **
* * *       *   *
* * *** * * *** *
* *         *   *
* *********** ***
* *       *     *
*   * *** **  * *
*      P        *
*****************
