*****************
*         *     *
* ******* * * ***
*       * * *   *
**** ** * ***** *
*   *     *   * *
* *** * * * *   *
*     *   *   * *
* ***** *** *** *
*G      *   *   *
***** * * *** * *
*     *   *   * *
* ********** ** *
* *           * *
* ***** ***** * *
*          P    *
*****************
