*****************
*   *   *       *
* * * * *** *** *
* *   *     *G  *
* * * ***********
* *   *         *
* *****  ****** *
* *     * *     *
*   ** *  * *   *
*         *   * *
* *** ** ** * ***
*     *  P*     *
*** *** * **  * *
*   *   *       *
* *** **** ** * *
*     *         *
*****************
