*****************
* *       *     *
* * * *** * *****
*  P*           *
***** * * * *** *
*   *     * *   *
*     * ***   ***
* *   *     *   *
* ******* **  * *
* * *   * *     *
*   * *   * * * *
*   * * * *   * *
* * * * * *** * *
* *   * * *   * *
* * * * * *  ** *
*   * *G    *   *
*****************
