*****************
*          G*   *
* *** *** *** * *
*   * *       * *
* **  * ******* *
* *   *   *     *
* *   *** * ** **
*P  *   * *     *
*  **** * ***** *
* *   * *   *   *
* * * ***** * ***
*   * *     *   *
* *** * * ***** *
* * * *     *   *
* * * ****    * *
*   *         * *
*****************
