*****************
*       *       *
* ******* *** * *
*       * * * * *
* ***** * * * ***
*   *P  *   *   *
*** * * **  **  *
* *   *       * *
* *** ********* *
*   * *   *     *
* * * *** * *** *
*   *     *     *
* *  **** ***** *
*G      * *   * *
* ***** * * *   *
*     *   * *   *
*****************
