*****************
*               *
* * * ********* *
*P*   *    G*   *
* ***   * *** * *
*   * * * *   * *
* *   *** * *** *
* * *     * *   *
* * *  ****  ** *
* * * *     *   *
* *** * ***** * *
*   * *       * *
* * * * * ***** *
*     * *     * *
* **********  * *
*             * *
*****************
