*****************
*G              *
* **** ******** *
*               *
* ***   * *** ***
* * * * * *   * *
* * * * * * * * *
*   * * * *     *
* ***  **  **** *
*       *     * *
*  ***  * * * * *
*       *   *   *
*********** *****
* *       * *   *
* * * *   * *** *
*      P*       *
*****************
