*****************
*               *
* ** * ******** *
*             * *
*** * ***** * * *
*   *     *    G*
* ********   ** *
* *     *   *   *
* * **  * *** * *
*P*       *   * *
* *** ***   *** *
* *   *     *   *
* * * *  ********
*   * *   *     *
***** *** * **  *
*               *
*****************
