*****************
* *             *
* * ****** **** *
*        G  *   *
* ** **** * *   *
*       * *   * *
* *** * * *** * *
* *   *         *
**  **  *********
*       *       *
* *** *** ***** *
* *       *   * *
* * **** **** ***
*  P*       *   *
* * * *** * * * *
*         *   * *
*****************
