*****************
*               *
* *** ** ** * * *
*         * *   *
* * ***** * *** *
* * *   *P  * * *
*** * * ** ** * *
*   *       *   *
* *** *****  ** *
* *   *   *   * *
* * *** *     ***
* * * *     *   *
* *** * *   * * *
*   *   *G*   * *
* * * *** ****  *
* *             *
*****************
