*****************
*     *         *
* *** *  ** **  *
*   *   * *   * *
*** * *** *** ***
* * *   *       *
*    ** * ***** *
*   *G  * *     *
*   * *** * *****
*     *     *   *
* **  *** * * * *
*         *   * *
* ** ******* ** *
*   *   *     * *
*** * * * *** * *
*      P  *     *
*****************
