*****************
*     *         *
* * * * *** * * *
*     *       * *
* *** ***  **** *
* *        G    *
* *** ****  * ***
*   * *     * * *
*** * * **** ** *
*     *       * *
* *** *** * *   *
* *   *       * *
* * *** * * * * *
* *   *     *   *
* ************* *
*    P          *
*****************
