*****************
*    G*         *
* *** * ***** * *
* *   *       * *
* * ******  * * *
* * *   *   * *P*
*   * * * *** * *
* *   * * *     *
* *****   ***** *
*   * * *     * *
*** * * *****   *
*   *         * *
* **** ** ***** *
*     *     * * *
* *** * **  * * *
*   *     *     *
*****************
