*****************
*           *   *
* ****  **  * ***
*   *P  * *     *
*** * **  * *** *
* *   *   *   * *
* ***** ** ** * *
*           *   *
* *** ***** *** *
*               *
* * ***   ***** *
*   *G  *   *   *
** ** * **  **  *
*     * *   *   *
* ******* *** * *
*             * *
*****************
