*****************
*             * *
*  ****** *** * *
*       *   *   *
******* *** * ***
*     *P  *     *
* *** *** ***** *
*   *     *   * *
**  * ****  **  *
* * *       *   *
* * *  ******   *
*   * *       * *
* **  *   *** ***
* *   * * *     *
* * * * ******* *
*  G* *         *
*****************
