*****************
*         *     *
*   *** *** *** *
* *     *   *   *
*   ***** ***  **
* *     * *   * *
* ** **** ***** *
*  G      *     *
* * * * ** ** * *
*     *       * *
*  ** *  *  *****
* *       *     *
* *** *** * *** *
*   *   *    P* *
*** ** ** ***** *
*               *
*****************
