*****************
*         *     *
* * *   *  * ** *
* *  P* *   *   *
* * *** ***   * *
* * *     *   * *
**  **  * *** ***
*   *   *     * *
* *** * ******* *
*     * *       *
*  **** * *******
*     *   *     *
*****  ****** * *
*   * *  G      *
*   * * ***  ** *
* *     *       *
*****************
