*****************
*    G* *       *
* *** * * ***** *
* *     *       *
* * *** * * * * *
*   *     *   * *
*** *  ** * * * *
*   *   *   * * *
* *** * * *** ***
* *         *   *
* * **** * **** *
*   *  P        *
* *** ** ** * * *
* *   * * * * * *
*   *** * * * * *
* *     *       *
*****************
