*****************
*   *           *
**  *  ***  * * *
*   * *     * * *
* *   * ****  * *
*     *       * *
* **    * * *** *
* *   *   *     *
* *   * ***  ** *
* *G* *       * *
*** * * *  *  * *
*   *   *     * *
* * * * * ***** *
*       *      P*
* ** *  ******* *
*     *         *
*****************
