*****************
* *      P    * *
* * ******* * * *
*   *       * * *
* **  *** * * * *
* *   * * * *   *
* * *   *** *****
* * *           *
***   * * ***** *
*   *G    *     *
* ***   * * *** *
*       * *   * *
*** * * * *** * *
*     *   *   * *
*   * *** * *** *
*   *       *   *
*****************
