*****************
*     *       * *
* **  **   ** * *
*G  *   *   *   *
* * *** * * *** *
* * *       *   *
* *  ****** * ***
*   *   *     * *
* *** * * ** ** *
*     * *       *
* ** ** * ** ** *
*   *   *       *
* * * ****** ** *
*   *  P*     * *
* * * * ** ** * *
*     *       * *
*****************
