*****************
*    G    *     *
** **  ** ***** *
*   * * * *     *
*   * * * * * * *
* *   * *   * * *
* * *** ***** * *
* * *       * * *
* *** *** * * * *
*     * * *   * *
* * *** * * *** *
*   *     *     *
***** *** * *** *
*   *     * *   *
* * * *****   * *
* *    P        *
*****************
