*****************
*   *           *
* * * * ***** ***
*    P*     *   *
* *** * ** ** * *
* *   * *     * *
* * * *   * *** *
* * *   * *     *
* * * *** * *****
* * * *   * *   *
*   * * *** * * *
* * *G*     * * *
*   *  **   * * *
* * *   *   *   *
* * *** *  *  * *
*   *   *       *
*****************
