*****************
*        P    * *
* ***** ** *  * *
*   *   *   *   *
* * * *** ***** *
*   *   *       *
* * *    *****  *
* *   * *       *
* *** * * *** ***
*   * * *   *   *
* * * * * ***** *
*   * *   *G  * *
* * * ***** * * *
* *         * * *
* * ***** *** * *
* *   *         *
*****************
