*****************
*        G      *
*  *** *  ***** *
*   *   *     * *
* *   * * * * ***
* * *     *     *
* * * * *   *****
*     * * * *   *
*  ****   * * * *
* *   * *   *   *
* * * * *** * * *
*   *   *  P    *
******* * ***** *
*     *       * *
* *  *****  * * *
* *         *   *
*****************
