*****************
*         *     *
* ******* **  * *
*             * *
*  *  ********  *
*  G    *   *   *
* *** * * *** ***
*   *   *   *   *
***** ****  *   *
*           *  P*
*  ** *** * *** *
*       * * *   *
* * * * * * * ***
*   *   * * * * *
* * *** * * * * *
*       *       *
*****************
