*****************
*   *           *
*  **  ****** * *
* *   *     * * *
* * * * ** *  * *
*   *         * *
* * *** **  *   *
* *         *   *
* * * * * *** * *
*     *   *   * *
*  **** *** *** *
*G    * *   * * *
* ******  *** * *
*       * * *   *
*   * * * * * ***
*   *     *    P*
*****************
