*****************
*         * *   *
* * ******* * * *
*         * * * *
* ******* * * * *
*   *   * *P* * *
*** *** * * * * *
*   *   * *   * *
* *** *** ***** *
*   *           *
***  ** *********
*     *         *
*  *   ** * *****
*   *   *      G*
* ****  *   *** *
*               *
*****************
