*****************
*               *
********* *** * *
*       * *     *
* ** ** *  ** * *
* *     * *   * *
* *  ****   * ***
*G*   *     *   *
*  * ** ******* *
*   * * *     * *
*** * * *  ** * *
*   *     *     *
* * *  ****   * *
*   *   *   *   *
* ******* ***** *
*P        *     *
*****************
