*****************
*               *
* *** *** *  ** *
* *   *   *     *
*** *** *****   *
*   *   *     * *
* *** *** * **  *
*         * *   *
** **** *** * * *
*       *   * * *
** ** * * ***** *
*     * * *   * *
* ***** *   * * *
*   *   * * *   *
* * ** **   *** *
*G          *P  *
*****************
