*****************
*G      *   *   *
* * * * *   * * *
* * * *     *   *
**  * ***** *** *
*   *   * *     *
* ***** * ***** *
*   *     *     *
* *   ***** *** *
* *   *     *   *
* *** *  **** * *
*   *P* *     * *
*** * * ** ** * *
*   *   *   * * *
* *** * * * *** *
*         *     *
*****************
