*****************
*   *           *
* *** *** ***** *
*   * *   * *   *
* *   * **  * ***
* *   * *   *   *
*    *  *   * * *
* *   *  G*   * *
* * * *  ** *** *
* * * *   *     *
* *    ** ***** *
*       *       *
* ***** * *  ** *
* *     *       *
* * * *** *   * *
*   *      P*   *
*****************
