*****************
*       *       *
* *** * *** **  *
* *   *     *   *
*** * * ***** ***
*     *     *   *
*   * ***** * * *
*P* * *   * *   *
* * * * * * *** *
* * *   *     * *
*  *****  * * * *
*   *     *  G  *
* * * *****   ***
* * *     *     *
* * * * * * *** *
*     *         *
*****************
