*****************
*               *
*    ********** *
* *   *         *
***   * ****** **
*     *         *
* **** * *  *****
*     *     *   *
* ***   ***** * *
*   *     *    P*
* * ******* *** *
*           * * *
* ***** * *** * *
*   *     *     *
*** **  *   *** *
*    G  *       *
*****************
