*****************
*       *      P*
* *   * ***** * *
* *   *       * *
* **  ********* *
*       * *   * *
* ***** * *** * *
* *     *   *   *
* * *** *** * ***
* *   * * * *   *
* **  *   * *** *
* *   *   *G*   *
* * * **    * * *
* *   *   * *   *
* *** ** *  * ***
*   *       *   *
*****************
