*****************
*       *       *
* *** * * *** ***
*   * * *   *   *
* * * *** * *** *
* *   *   * *   *
* *** *  ** * ***
* *   * *    G  *
* *  ** *** *** *
* *   *   *   * *
* **   **   * ***
* *P  *   *     *
* * * * *** * * *
*   * * *   *   *
* *** * *** *** *
*   *       *   *
*****************
