*****************
*       *       *
*****   * * *** *
*     *P  * * * *
* ** ** * * * * *
*           *   *
* ********* * ***
* *     *   * * *
* ***** * *** * *
* *     *     * *
* * **   ***    *
* * *G  *       *
* *   * *    * **
*   *   * *   * *
****  *** * *   *
*               *
*****************
