*****************
*         *     *
* * ***** * *** *
* * *   * * *   *
* * * * * * * ***
* * * * *G    * *
* *   * ******* *
* *   * *       *
* *** * * *** * *
*   * *         *
* * * *****     *
*   *       * * *
* *** *** **  * *
*P*   *     * * *
* * *   *** * * *
*   *     *     *
*****************
