*****************
* *           * *
* * *****  ** * *
*   *   *  G*   *
* *** * * * **  *
* *   * *   *   *
* * *** * * *  **
* * * *     * * *
* * * ******* * *
*   *         * *
* *   ** ** *** *
* *   *    P*   *
**  *** *** * * *
*   *   * * * * *
* *   *** * * * *
*     *       * *
*****************
