*****************
*   *  G    *   *
* * * *** * *** *
* *   *   *     *
* ** ** ******* *
* *   *   *   * *
* *** **    *   *
*   *     * *   *
* * * **  ***** *
* *   *       * *
* * *** *** * * *
* * *   *   * * *
* * * *** * * ***
*   *       *   *
* ******** ***  *
*         *P    *
*****************
