*****************
*             * *
** ******** * * *
*    G          *
*  ************ *
*             * *
****** ***  * * *
*     *     *   *
*** * * ** ** ***
*   * *     *   *
* **** ***  *** *
*P*     * *     *
*   * *   **  * *
* * * *     * * *
* * * ******* * *
*   *           *
*****************
