*****************
*P    * *   *   *
* *** * *   * * *
*   * *   *  G* *
****  * ******* *
*   * * *     * *
* *   * * ***** *
* *   *         *
* *** *** * * * *
*     * *   *   *
* * *   * *  ** *
* *       * *   *
* ********* * * *
* *   *   * * * *
* * * * * * * * *
*   *   *   *   *
*****************
