*****************
*   *       *   *
*** * *** ***   *
*   *P  *     *G*
* * * * ** **** *
* * * * *       *
*  **   * ***** *
*       * *     *
*  ****** *******
*     * *       *
** ** *  *****  *
*   * *       * *
*   * ******* * *
* * *       * * *
* * *** *** * * *
* *         *   *
*****************
