*****************
*               *
* ** ** * ***   *
* *       *     *
*  ** * ****** **
*   *           *
**  *  ******   *
* *G*       *   *
* * *** ***   * *
*   *   *   * * *
* **  *** *** ***
* *   *   * *   *
* **  * *** *** *
*     *       * *
** ****** *    **
*        P      *
*****************
