*****************
*       *    P  *
*** *** * * *****
*   *     * *   *
*  ****** **  * *
*   *     *   * *
*   * *   * *** *
* * * * *   * * *
*** * * * ***   *
*     *   * *   *
* * *  ****   ***
* * * *G    *   *
*   * * ***** * *
* * *   *       *
* ******* ***** *
*               *
*****************
