*****************
*      G*       *
* ***** *  **** *
*   *           *
*** * * ***  ** *
*   *   * *     *
* ***** * * * * *
*             * *
*   ***** *** * *
* *     * *     *
* * * * *** *** *
*P* *   *   *   *
* *** * * * * * *
*     * *     * *
* ****  *** *** *
*     *         *
*****************
