*****************
*   *           *
* * * * * ** ** *
* * *G* * *   * *
**  * * * * *** *
*   * * * * *   *
* *** * * * * * *
*     *     * * *
* *********** * *
*         *   * *
***  ***    *** *
*   *   * * * * *
* *** *   *   * *
* * * * * * *   *
* * * ** ** * ***
*   *P      *   *
*****************
