*****************
*P    *       * *
* * * * * * * * *
*   *   * * *   *
* * **  *** *** *
* *   *     * * *
* * * * * **  * *
* *     * *   * *
*  ** *** *** * *
*    G    *   * *
* * *** **  *** *
* *     *   *   *
* ***** * * * ***
* *           * *
*   * ******* * *
*   *           *
*****************
