*****************
*     *   *     *
* * * * * * * ***
*   * * *   *   *
* *** * **** ** *
*   *  G    * * *
*** * ****  * * *
*   *   * * * * *
* * * * * * *   *
*   *     * * * *
*** * * * * * * *
*     *   *   * *
* **** ** * *** *
*P*     * * *   *
* * *** ***   * *
*     *     * * *
*****************
