*****************
* *           * *
* * *********   *
* *   *     *   *
* *** *** ***** *
*       *       *
* * *** *** *   *
* *  G*   * * *P*
* *******     * *
*       *   *   *
* ***  *******  *
*   * *       * *
*** * * * ***** *
* * *   *     * *
*    ** * * * * *
*       *   *   *
*****************
