*****************
* *    P      * *
* * *** * ****  *
*   * *   *     *
* *** ****  * ***
* *             *
* ************* *
* *           * *
* *  ******** * *
* * *     * *   *
* * * *** * *** *
*     *   *   * *
*  ***  *** * * *
* *G  * *   * * *
* * * *   * *** *
*       * *     *
*****************
