*****************
*    G          *
* ** **** **  * *
* *       *   * *
* *   * * ** ** *
* *     *   *   *
* * ******* * * *
*   *     *   * *
*   * * ******* *
*   *       *   *
***** * * **  * *
*   *   *     * *
* * *** ** **** *
* *       *     *
* *** *** * *** *
*P          *   *
*****************
