*****************
*     *         *
* *** * ******* *
* *   *   *     *
* * * **     ** *
*   *  G  *     *
* * *** *** * * *
* *     *       *
* *** *** ***** *
*   *   * *     *
*** *** *   * * *
*     *   * * * *
* * * * * **  * *
*P*   * * *   * *
* * * * * * *** *
*   *       *   *
*****************
