*****************
* *       *    G*
* *** *** ****  *
*     *       * *
*******  **** * *
*P      * *   * *
*** *** * * **  *
*   * *   *   * *
* *** *** *   * *
* *         * * *
* ***********   *
*           * * *
* ********* * * *
* *     * * * * *
* *** * * * * * *
*     *   *     *
*****************
