*****************
* *          P  *
* * ***** ***** *
* * *   *     * *
* * * * * * *** *
*     * * *     *
***** * * *   ***
*     *   * *   *
* *** ***** * * *
*     *   *   * *
*  ** * * ***** *
*       * *G*   *
* ******    * ***
* *   *   *   * *
* * * * *** *** *
*   *   *       *
*****************
