*****************
*               *
*   ***   *** * *
* * *     *     *
* * * *** * * ***
*P* * *   *     *
*** * *****  ** *
*   *           *
* ************* *
*   *     *     *
*   * *** *** ***
* * *   *   *   *
*** * * * * **  *
*   * *     *   *
* **  ******* * *
*        G      *
*****************
