*****************
* *     *   *   *
*   * * * *** * *
*   *   *     * *
*****   ******* *
*       *       *
* ** **   * *** *
*     *G  *   * *
* *** **  *** * *
*   * *         *
*** * * ****** **
*   * * *       *
* *** * *** * * *
* *   *     *   *
* * **** **** ***
* *        P    *
*****************
