*****************
*        P*   * *
*  *   ** *   * *
*   *   *   *   *
**  *** *** *** *
*       *       *
**** **   ***** *
*   *   * *   * *
*   * * *** * * *
* *   *   *   * *
* ***** * *   ***
* *     * * *   *
*   * **  * *** *
* *   * *  G    *
* * * * ***** * *
*     *       * *
*****************
