*****************
*G              *
*   * ********* *
*             * *
* **** ** *** * *
*     *   * * * *
* ***** *** *** *
*       *     * *
* *** ***** *   *
* *         * * *
* *** * ***** * *
*  P    *     * *
****** ** ** ** *
*       *     * *
* *** ******* * *
*               *
*****************
