*****************
*               *
* * *** **  * * *
* *   *   *   * *
*  ** *** ***   *
*   * *         *
*** * ********* *
*   *         * *
* * *********   *
*       *      P*
***** *** *******
*    G*   *   * *
* * *** *** *   *
* * *   *   *   *
* ***  **** *** *
*           *   *
*****************
