*****************
*  P    *       *
* *** *** ***** *
*   *   * * *   *
* * *** *** * ***
*   *   *       *
** **   * ***** *
*     * * *     *
*  **** * *  ** *
*         *   * *
* **  *** * * ***
*       * * *   *
* * ***   * *** *
* *   * *     * *
* *** ******  * *
*   *          G*
*****************
