*****************
*       *       *
*  ** * * *******
*P*     *       *
* *  **** ***** *
* *     *   * * *
*  **** *** * * *
* *   *   *   * *
* *** **  ***** *
*   *   *     * *
* * * ***** * * *
*   *           *
* * *  ******* **
* * * *         *
* * *** * * *** *
* *      G    * *
*****************
