*****************
* *    P*     * *
* * * *  ** * * *
* * * *     * * *
* * * *** *** * *
* * *   *   * * *
* * *** * * * * *
* *   *     *   *
*  ** * *** *** *
*   * * *     * *
* *** * * ** ** *
*     * * *   * *
* ***** * * * * *
*     *     *G  *
*  ** * * *******
*   *   *       *
*****************
