*****************
* *     *      P*
* * *  **  * ** *
*   * *   *     *
* **  * **  *** *
* *   * *       *
* *  **  ** **  *
* *  G*   *   * *
* *** * *** *** *
*   *         * *
*** ****** *  * *
*           *   *
*  ******** *****
*   *     *     *
* * * *** * * * *
*     *       * *
*****************
