*****************
* *        P  * *
* * *** * *** * *
*   *     * * * *
* **  ***** * * *
* *   *     * * *
* * *** ***** * *
* *   * *     * *
* *** * ***  ** *
*     *   * *   *
***** *** *   * *
*   *       *   *
*   * * **** ** *
* *             *
*  ******** * * *
*             *G*
*****************
