*****************
*   *           *
*  ** * ***   * *
*     *         *
* ***** *** *****
*P*       *  G  *
*** * **  ****  *
*   *   * *     *
*  **** * * *** *
*     * * *   * *
* *** * *** * * *
* *   *       * *
* * ****  ** ** *
* *     * *     *
* **  * * *  ** *
*         *     *
*****************
