*****************
*       *     * *
* * ***   *** * *
* * * *   * *  G*
* * * * * * *** *
*   *P  *   *   *
* * * * ** ** ***
* *   *     *   *
*    ** * ***** *
* *     * *     *
* ******  * *****
* *     * *   * *
* * **  * *** * *
* *     *   * * *
*  * *    *** * *
*       *       *
*****************
