*****************
* *         *   *
* * *** *** *** *
* *   * * *     *
* * * * * **  * *
* * * * * *     *
* * * * * * *****
*     * *     * *
* * *** ***** * *
*P  *   *   * * *
* *     * * *** *
* *   *   *G    *
* * * **  *******
*   *   * *     *
*** *** * *** * *
*     *       * *
*****************
