*****************
*               *
* * *** ******* *
*G*       *   * *
***** ***** * * *
*   *     * *   *
* * * *** * *****
*         * *   *
* ***** *** * * *
*     *   *   * *
* * * *** * *** *
* * *   * *   * *
*   *** * ***** *
* *   * * *     *
* * *     * *** *
*   * *    P*   *
*****************
