*****************
* *             *
* * ******** ** *
*   *          P*
***** * ******* *
*     * *   *   *
* * ***** * * ***
* *G*   * * *   *
* *** * * * *   *
*     * * * *   *
*** * * * ***** *
* *   *   * *   *
* ***** **  *  **
* *           * *
* * ***  *** ** *
*               *
*****************
