*****************
*     *         *
* *** * ******* *
*   * *   *     *
*   ***** * * * *
*         * *   *
* *** ***   * ***
*   *  G  *     *
*** *****  **** *
* *   *   *     *
* *** * *** * ***
*   * *   * * * *
* * * * * * *   *
* *   *   * *   *
* * * * * * * * *
* *  P  * *     *
*****************
