*****************
*   *           *
* * * ** *** ** *
* * * *   *     *
* * * * *   *** *
* *P  * *   *   *
* * **   **** * *
* *   *   * * * *
*** * *** * * * *
*   *     * * * *
* ***   * * * * *
*   * * *     * *
*** * * ***  ** *
*   *   *G      *
* ******* ****  *
*         *     *
*****************
