*****************
*               *
* ** ** *** * * *
* *P    *     * *
*  ** *** * * * *
*   * *   * *   *
*   *** * * * * *
*       *   *G  *
* *** *** *** ***
*     * * * * * *
* *   *  ** * * *
* * *         * *
***    **** * * *
*   *     *   * *
* * *** * *** * *
*       *       *
*****************
