*****************
*   *   *       *
* *    ** ** ** *
* *   *   *     *
* *** * *** *****
* *   * *   *  P*
*  **** *  ** * *
* *   * * * * * *
* * * * * * *   *
* *   * * *   * *
* * * *   * *   *
*   * *         *
* *** * *** **  *
* * * *   * *   *
* * * ***   *  **
*  G*       *   *
*****************
