*****************
*     *   *     *
* *   *   ***** *
*   *   *   *   *
* * *** * *** ***
* *   * *   *  G*
*  ** * **  *** *
* * * *   *   * *
* * * * * *** * *
*       *     * *
* ********* *** *
*P              *
* * *   *********
* * * * *       *
* * * * * * *** *
*   *       *   *
*****************
