*****************
*               *
* * * * *** * * *
* *   *   * * * *
** ** *** *** * *
*  G  * *     * *
* ***** * * *** *
*   *   *   * * *
* * * ** ** * * *
*   *         * *
* **    * * *** *
* *   * *   *  P*
* * *** *** * ***
* * * *   *   * *
* * * * *  ** * *
*   *           *
*****************
