*****************
*             * *
*   ****** ** * *
* * *           *
* *   *** *** * *
* *P*       *   *
* * ********* ***
*   *       *G  *
*** * * * *   * *
* * *     * *   *
* * ***** * * * *
* *       * * * *
* ***** * *   * *
*   *   * * * * *
* * * *** * **  *
* *       *     *
*****************
