*****************
*  P            *
** *  *   ***** *
*   *   *       *
*** * * *** *   *
*   * *   * * * *
* *** * * *** * *
*     * *   *   *
* *****  ** * ***
*   *   *G  *   *
* * * * * * * * *
* *   * * *   * *
* * *** *   * * *
* *   * *   * * *
* * * ******* * *
*   *           *
*****************
