*****************
*           *   *
* *** ** ** * * *
* *   *   *P* * *
* * *** * *   ***
*   *   * * *   *
*** * * ***  ** *
*   * *         *
* *****  ** *****
*     *     *   *
* *** **** ** * *
* * *    G    * *
*    **** * *** *
* *             *
* ***** * * *** *
*       *   *   *
*****************
