*****************
*     *         *
* ** **    **** *
*       *       *
*  **  **** * ***
*    G      * * *
* *** * *  ** * *
*   * * *   *  P*
* * * * *** *****
* * *   * *     *
* *  **   ***** *
* *   *   *   * *
* ******* * *** *
*       *   * * *
* * * * * *   * *
* *   *     *   *
*****************
