*******************
*                 *
* *******  ****** *
* *     *    G    *
* *   * * *** *   *
* *     *       * *
*  *  * *** ***** *
*     * *   *   * *
* ***** *****   * *
* *   * *     *   *
* * * * *   ***** *
* * * * *   * *   *
* * *    ** * * ***
* * *       * *   *
*** * **** ** *** *
* * *   *     *   *
* * * * * *** * ***
*     *     *    P*
*******************
