*******************
*     *     *     *
* *** * * * * *** *
*   *     *    P  *
* * ***** * *** ***
* * *   * *       *
***   ***  ****** *
*G  *     *     * *
* *** ***** *** * *
*   *             *
*** *********  ** *
*   *   *     *   *
* *** * ******* * *
*     *         * *
* *******  ****** *
*   * * *   *   * *
*** * * ** ** * * *
*     *       *   *
*******************
