*******************
*       *         *
*  ** *   ******* *
*   * *    P*     *
*** * *  ** *  ** *
*   * *   * * *   *
*  *  *** * * *** *
*     * *       * *
**** ** **    * * *
*     * *   * * * *
*** * * * * * * ***
*   *   * *   *   *
* ** **** * * * * *
* *     *   * * *G*
* * *   ** ** * * *
* *   *   *   *   *
* *** **  * *** * *
*       *         *
*******************
