*******************
*       *         *
* *  **** ***     *
* *     *   *     *
* ***** * * ** ** *
* *   * *   *   * *
*   * * ***** * * *
* * * *       * * *
* *** *  *  ***** *
*         * *     *
* * *** *   * ** **
*       *         *
* *** *** * *** * *
*P      * *   * * *
* ****    * *   * *
*     * * *G* *   *
* * * *   * ***** *
*   *             *
*******************
