*******************
*           *  G  *
* ** ** *   ***** *
* *     * *     * *
* *  ** * ** ** * *
*   *   *     *   *
* * * *** *** *** *
* *     * * *     *
* *   * * * *******
*   * *     *     *
*  * **** * *** * *
*         *   * * *
* * ** ** *   * * *
* * *       * *   *
*** * *  ** *    **
*   * *P      *   *
*  ** ******* * * *
*     *           *
*******************
