*******************
*                 *
* * * * * ** **** *
* * *   *         *
* * ** ** ** *** **
*     * * *       *
*   * * * * **  * *
*     *  G    * * *
*** *** * ***** * *
*   *       *     *
* *** *** * * *** *
*   * *       *   *
*** *** *   * * ***
*   *     *   *   *
* *** **********  *
* *   *     *     *
*    **  * **  ****
*   *            P*
*******************
