*******************
*G          *     *
***  **   *** *   *
*   *         *   *
* ** * ** * ** ** *
* *     *     *   *
* * * * * *** **  *
*   *       * *   *
* **  ***** *   * *
* * * * *   *   * *
* * *     **** ** *
*   * *   *     * *
** **  **** *  ** *
*     *     * *   *
* *** * ***** * ***
*   * *     * *   *
* * ******* * *** *
* *        P*     *
*******************
