*******************
*               *G*
* * * ****** ** * *
*   *   *   * *   *
***** * * * * *** *
*   * * *   *   * *
* * *** *** * * * *
* *       *   *   *
* *** * **  * *****
*   *   *   * *   *
***   *** *** * ***
*   * *   *   *   *
* ***   *   * *** *
* *     * * *     *
* * *** * * *** * *
*P* *     *   * * *
* * * ******* * * *
*               * *
*******************
