*******************
* *             * *
* * *** * ***** * *
*       *   *     *
* ***** * * *******
*   *     *   *G  *
* * * *****   * * *
* *   *   * *   * *
* *** **  ** ** * *
* *     *     * * *
* * ***   * * *** *
* *   * *     *   *
* ***** * ***** ***
* *   * * *       *
* * *   * * ** ** *
*   *  P*       * *
***** * ***** * * *
*             *   *
*******************
