*******************
* *   *     *     *
* * * * *   * *****
* * *   * * *     *
* *   *   * ** ** *
*   *   *       * *
* **** ** ***** * *
*   *   * *   *   *
***   * * * * * * *
* *     * * *   * *
* * * *** ***** * *
* *   *   *   * * *
* *** * * * * *** *
*    G* * * *     *
*** * * *** *******
*   * *   * *     *
* *** * * * * * * *
*       *       *P*
*******************
