*******************
*   *         *P  *
* * * *******     *
* *       * * *   *
*  **** * * *** * *
* *           * * *
* * * ******* * * *
*     *       * * *
**** *  *** **  ***
*     *   * *     *
* *** * *   ****  *
*   *   * *   *   *
*** * * *   * * * *
*           *   * *
* * ** *** *** *  *
* *         *   * *
* * * *** * * * * *
*    G        *   *
*******************
