*******************
*   *             *
* **  *** *** * * *
*       * *   * * *
* * *  *    ** ** *
*         * *     *
* *** ***** *** * *
*   *   *   *   *G*
* * * *    ** ** **
* * *         *   *
* * * ***  ** * * *
* *     *   *   * *
*** ***     *** * *
* *   * *         *
* ***   ** *** *  *
*   * *   * *     *
*** * ***   * *****
*         *    P  *
*******************
