*******************
*     *           *
* * **  ***** * * *
* * *   *   *     *
*   *  ** ******* *
*      G*         *
*** *** *** * * ***
*     *     *     *
* *** *** *** *** *
*   *   *   * * * *
* * ******* * *   *
* *           *   *
* ***** * *****  **
*     *       *   *
***** * ********* *
*      P*         *
* ** * ** ***** ***
*                 *
*******************
