*******************
*           *     *
* * ***   *** * ***
*  G    *     *   *
*** ************* *
*   *             *
** *  *  ***** ** *
*     * *       * *
* * ***** * *** * *
* * *   * * *   * *
*  ** *   * * *** *
*   * * * * *     *
*** * * * * *** * *
* *   *   *     * *
*  **  *  * * **  *
*       *         *
* ***** * * *  ****
*     *   *P      *
*******************
