*******************
*     * *         *
* **  * * * *  ****
* *     * *      G*
* *** *** * *** * *
*   *       *   * *
* * *** *** *** * *
*   *   * *     * *
*** * *** ** ** * *
*   * *   *     * *
* *** * ********* *
*     *           *
* *** * * ******* *
* * *   *   *     *
* * * ***** * *****
* * * *    P  *   *
* *   **  *** * * *
*   *     *     * *
*******************
