*******************
*     *           *
* ***** ******  * *
* *     *   *   * *
* * *** * *   *****
*   *     * *     *
* * *** * ****  * *
* *     * *   * * *
* **  **  *   *** *
*   * *     *     *
**  * * *  ****** *
*     *   *     * *
******* * * *** * *
*  G              *
*  ** *****  * ****
*         *      P*
* ******* ** **** *
*       *         *
*******************
