*******************
*         * *P    *
** ** *** * * * ***
*     *       *   *
* **  ** ** * *** *
* *     *     *   *
* * ***    ** * ***
*   * *   * *   * *
* **  * *   ***** *
*                 *
*************** * *
*     *    G    * *
* *** * *****     *
*               * *
*  **** * ******* *
* *   *   *     * *
*   *  **** ***   *
*   *             *
*******************
