*******************
*     *         * *
* *   * * ***** * *
*   *   *   *  P  *
* * * * * * ****  *
*   *   * *   * * *
*** * *** * * * * *
* * *   *   * *   *
* * * ** ** * *** *
* * *     * *   * *
* * ***   * *** * *
* *     *   *   * *
* *  ***** ** *** *
*         *   *   *
* *** * *****   * *
* *   *G      *   *
* * *** ***  ** * *
*         *       *
*******************
