*******************
*                 *
* ********  * * * *
*   *         * * *
* * * *** * *** * *
* *   *   *     *G*
* ** ** *** * * * *
*     *P  *   * * *
* *** *** ***** * *
*       * *     * *
*** *  ** ***** * *
* *   *   *   * * *
* * * * *** * * * *
* *     *   *     *
* * * *** ***  ** *
*   *           * *
* ********** ** * *
*         *     * *
*******************
