*******************
*     *P          *
* **  * *** ***** *
* *               *
* * *** * ** ** * *
* *     * *   * * *
* ***  ** * * *** *
*           *   * *
* *** * **** ** * *
*     *       * * *
*   ** ****** * * *
* *   *G    *     *
* *** * * * *******
*   * * * *       *
** ** * * *********
*     * *   *     *
* *****   *  * ** *
*         *       *
*******************
