*******************
*         * *     *
* * ***** * * * * *
*       * *       *
******* * ****  * *
*       * *   * * *
* * * *** * * * * *
*     *   * * * * *
* ***** *** *** * *
*G    * *   *   * *
***** * * *** *** *
*     *   *  P*   *
* ***********  * **
* *               *
* * *  **** * *** *
*     *   * * *   *
**          *** * *
*     * *       * *
*******************
