*******************
*               * *
*** ***** * ***   *
*   *   * * *     *
*  **** * * * *** *
* *     * *       *
* *** ***  ****** *
*   *   *         *
*** * *  ** * *** *
*   * *   * *  P  *
* **  * **  *  ****
*   * *     *   * *
* * * **** **** * *
* * *         * * *
* * **********  * *
*  G*         *   *
* * *  ****** *** *
*                 *
*******************
