*******************
*     *     * *P  *
*** *   *   *   * *
*   * *   * *   * *
* * * ***** ** ** *
* *       *     * *
* *****   ***** * *
*     *       * * *
* *** * ******* * *
* *   *   *   * * *
* * * ***** * *   *
* *     *   * *   *
* ***** * **    * *
* *       *       *
* * * ***** *** ***
* *G*     *     * *
* ***** * **  *** *
*       *         *
*******************
