*******************
*           *     *
* ** *****  * * * *
* * *     * *P*   *
* *   * *** * * ***
* *   *     * *   *
* *** * * ******* *
*     *   *     * *
* **  * *** *** * *
*   *       *     *
* * * **  *********
* *   *   *       *
**  **** ** *** * *
*G  *       *   * *
* *** ******* *****
*     *   *       *
* *** *   * ***** *
*       *         *
*******************
