*******************
*     *    P*   * *
* * * * *** * * * *
* * *   *         *
* * * * * ***  ** *
* * *         *   *
*** * ***** *** ***
*   * *   *       *
* ***** * ***** * *
*       * *       *
* ******* * *******
*       *   *     *
**  *** ***** *** *
*      G*     *   *
* ************* ***
* *       *   *   *
* ***** * *   *** *
*       *   *     *
*******************
