*******************
*         *   *   *
* *   * * * * * ***
* *     *     *   *
* *****   *** * * *
* *     *P  *     *
* * *** * *  **** *
* * *     *     * *
* * * ******* *** *
* * * *     *     *
* * * *** * * * ***
*   *           * *
*  *** ******** * *
* *         *   * *
* *   * ***** *** *
*   *   *      G* *
* * ** ** * ***   *
* *       *       *
*******************
