*******************
*       *         *
* *** * * *** *** *
* *   *   *P* * * *
* * *** * * * * * *
*   *       * *   *
* **  *** * * * ***
* *   *       *   *
*   * *******  ** *
* * *             *
* * * ***** ****  *
* *   * *   *     *
*  **   ***** *** *
*  G*           * *
*** * ***** **    *
*   * *   * *   * *
* ***** * *** *** *
*             *   *
*******************
