*******************
*                 *
* ****  ****  * * *
*     *     * * * *
*** *** **    * * *
* * *   *G* *   * *
*   *      ** *** *
*   * *     * *   *
****  **  * * * ***
*     *   *   *   *
*  * ** ** * *  * *
*   *           * *
*** ***** * ****  *
* * *   * *     * *
* * *   **  ***   *
* * * *   *   *P  *
*   * **  *** **  *
*     *       *   *
*******************
