*******************
*P  *             *
* * * * *** ****  *
* * * *     *     *
* *   * ***** *****
* * * *     *   * *
* * * * * * *** * *
*     *   *   *   *
* * * ***** * **  *
*         * *   * *
** *** ** * *** * *
*      G*     *   *
* * *** ***** *   *
* *   *     * *   *
* * ********* * ***
* *       *     * *
* ***** * *** * * *
*       *     *   *
*******************
