*******************
*     *       *  G*
* **  * * ****  * *
*   * *     *     *
*** * *** * * * * *
*   *   *       * *
* ***** *  ****** *
*   * *   *       *
* * * * **  * ** **
* * *   *   * *   *
*    ** *    ** * *
* *   *P  * *   * *
*  ** ******* *** *
* * *         * * *
* * **** * ***  ***
*           *     *
*** ******* ***** *
*                 *
*******************
