*******************
*       *     *G  *
* ***** ***   *  **
* *   *       *   *
* * ** *****  * * *
* *         * * * *
*  ****** *** *** *
*       *   *   * *
* ** ** *** ***   *
*   *   *     *   *
****  *** ******  *
*     *           *
*  * ***  *********
*         *  P*   *
***** * * *   *** *
*   *   *   * *   *
* * *** ***** *   *
* *     *       * *
*******************
