*******************
*   *             *
* *** **  * * * * *
*   *     *     * *
***  **** * *** ***
* * *   *   * *   *
*   * * *** * *** *
*P  *     * *   * *
* *   *** * * **  *
*   *   * * * *   *
* *** * **  * * * *
* *   *       * *G*
* **********    * *
*   *     *   * * *
***    ** **  * * *
* * * *   *     * *
* * * * *** **  * *
*     *     *     *
*******************
