*******************
*           *     *
* ******* *** * ***
* * *   *   *     *
* * * *  ** * *** *
* *P* *           *
* * * ***** * *** *
*   *       * *   *
**  * * * *** * * *
*   *         * * *
* *  ** ******* * *
* *         *  G  *
* *   ***** * *** *
* * * *   * * *   *
* *     * * * * * *
* *   * * * * *   *
* *** * *** * * * *
*             *   *
*******************
