*******************
*    G      *   * *
* **** **** * * * *
* *       *   * * *
*   ***** *****   *
*       *   *   * *
* **  * * * * **  *
* *   * *   * *   *
*   *** **  * * * *
* * * *     *   * *
*** * *********** *
*   *           * *
* *** ***  ****   *
* *   * * *P    * *
*** *** * * ** ** *
*   *   * *       *
* *** * * * *******
*     * *         *
*******************
