*******************
*     *   *       *
*   *** * ** ** * *
*   *   * *     * *
* *** *** * *** * *
*     * *   * * * *
* * *** ***** * * *
*       *       * *
******* * * **  * *
*  P         G  * *
* * *** * *** **  *
* *     *   * *   *
* *** * *** * * ***
* *   *   *   *   *
* * ***** ******* *
* *     *         *
* ***** ***  **** *
*                 *
*******************
