*******************
*    P        *   *
**** *  * * *** * *
*     * * *     * *
*  ** * * ***** * *
* *   *   *   * * *
* * ******* * * * *
* *         * * * *
* * * * * ***  ** *
*     * * *     * *
* ** ** * * *** * *
*   * * *     * * *
* * * * * **  * * *
*  G*         *   *
* *  *** *** **** *
*           *     *
* *** *  ** * *** *
*   *     * *     *
*******************
