*******************
* *       *       *
*   * *   *****   *
*   *  P*     * * *
* ***** ** ** * * *
*     *     * * *G*
*** ******* * * * *
*   *       * * * *
* * * *** * * * * *
* *   *         * *
* ***** *** ***** *
* *   *   *       *
* * * *** * * *  **
* * *   * * *     *
* * **  * ***** * *
* *     * *       *
* *   * * * ***** *
*   * *     *     *
*******************
