*******************
*     *     *     *
* *** *   ***  ** *
*   *   * *     * *
***  ******   **  *
*   *G  *     *   *
* *** * * **  * * *
* *   *   *     * *
* * *** * *** *   *
* *     *     * * *
* * *** *   * * ***
* *           *   *
* * ************* *
*     *           *
* * ***   ***   * *
*   *     * *   * *
* *** *** * * *   *
*   *    P*     * *
*******************
