*******************
*   *       *   * *
* * * *  *  *     *
* * * * *   * *   *
* * **  *** *  ** *
* *       * *     *
* **  *** * ***** *
*   *     *       *
***  ******   * ***
* *   *     * *   *
* *** *  ** * * * *
*     * *   * *   *
**  * * ***** *** *
*  P*   *         *
* * ***** ******* *
* *   *   *     * *
*  * ** *   * *** *
*       *   *G    *
*******************
