*******************
*         *  P    *
* * * *** * ** *  *
* *     * * *   * *
* ** **   * *   * *
* *     * * *   * *
*   * *** * * * * *
*   *     *   *   *
* * *** *** *  ** *
*   *       * * * *
* * * *** **  * * *
*   *         * * *
**** ** *** *** * *
*       *   * *   *
* ******  ***   ***
* *      G* *     *
* * ***   *    ** *
*   *     *       *
*******************
