*******************
*       *      P  *
*   * *  **** *** *
* *   *         * *
*** **** ** * **  *
*   * *   * * *   *
* *** * * * * * * *
*     * *   *   * *
* *** *  * **   * *
*     *       * * *
* *** ***** ***   *
*   *     *       *
*** *****   *** * *
*   *     *   *   *
* * ******* * *****
*           *     *
*  * ************ *
*            G    *
*******************
