*******************
*     *           *
* * *** ** ****   *
* *     *     * * *
* ** **** *** * ***
* *   *   *   *   *
* * *  ** ******* *
* * *   *G  *     *
* * *** *** *  ****
* *     *         *
* * * *** *** * ***
* * *     *   * * *
* *  **** * * * * *
* * *     *       *
* * * ***** ***** *
* *       * *     *
* * *** * * * *****
*  P*     *       *
*******************
