*******************
*   *       *     *
* * * * *** * * * *
* *         * * * *
* *** **** ** * * *
*   * *       *   *
* * **   ***** ** *
* *  P  *     *   *
*  ********** *  **
*   *       * *   *
* * * ***** *  ** *
* * *   *   *   * *
* * * * * ***** * *
* *   *         * *
* * *** *** ***** *
*     * *   *    G*
* * * * * * * * * *
*       *   * *   *
*******************
