*******************
*         *     * *
***    ** * * * * *
*   * *   * *     *
* *** * ***** *** *
*     *       *   *
********* * **   **
*       *         *
******* * * * *** *
*   *   * *   *   *
* * *   * ***     *
*P*   * * *   *   *
*  * * ** * *** * *
*         * *  G  *
* *****   * *** ***
* *   *   *   *   *
* *** ** ** * * * *
*             *   *
*******************
