*******************
*P      *     *   *
* *** * * *** * * *
* *     *   *   * *
* * * *** *     ***
* *           *   *
* ******** **** * *
*     *           *
* *** * **  * * * *
*   * * *       *G*
* *** * * *** * * *
* *   * *   * *   *
* * * * ***** * ***
* * * * *     * * *
*   *   * ***** * *
* * * *   *   *   *
* *  ****** ***** *
* *               *
*******************
