*******************
*   *     * *     *
*   * * *** * *** *
* * * *G    * *   *
* *** *** * *   ***
*         * * * * *
******* * * * * * *
*       * *   * * *
* * ***********   *
*                 *
* *    **** *** * *
* * * *   *     * *
*   * *  ******** *
*     *  P  *   * *
* ** **** * * * * *
* *       *   * * *
*  * ** * ***** * *
*       *         *
*******************
