*******************
*       * *       *
* ***   * * * *** *
*   * * * * *   * *
*** * * * * *** ***
* * * *   * * *   *
* * *   *** *  ** *
*   *   *     *   *
* *   *   *** * ***
*         *  P*   *
* * *** * *** *** *
*G* *   *     * * *
*** * ******* * * *
*   * *   *   *   *
* ***** * * *** * *
*           *   * *
*  ************** *
*                 *
*******************
