*******************
*             *   *
*** * ******  * * *
*   *      G    * *
* *** *****  **** *
*   * *   *       *
* * * * * ***** * *
* * * * *     *   *
*** ***     * *** *
*   *   *   *   * *
* * *  * **  ** ***
*   * *       *   *
* * * * ****   ** *
* *     *       * *
* * ****   ****** *
*  P    * *   *   *
* *  ** *** * * ***
*                 *
*******************
