*******************
*         *       *
* ******* *  **** *
* *   *   * * *   *
*** *   * ***    **
*   *   * *     * *
*  ** ***** *** * *
*         * *     *
* * ***** * * **  *
* * *     * * * * *
* * *  ** * * * * *
* * * *   * *G  * *
* * * *** * ***** *
*   *     *     * *
* * *** ******* * *
* *P  *     *   * *
* *** *** *   *** *
*                 *
*******************
