*******************
*           *   * *
* ******* * *   * *
*             *   *
** *** ****** *** *
*G*           *   *
* * *** ****  * ***
* *   *   *   * * *
*  *    *** *** * *
* *   *     *     *
* * *** * * * *** *
*       * *   *   *
*****  ** * * * * *
*               * *
* ******* ******* *
* *   *   *       *
*   *  **** * *** *
*   *    P        *
*******************
