*******************
*                 *
* * * *********** *
*   * *        P* *
*** * * *** ***** *
* * * *   *       *
* * * *** * * *****
* * *     *   *   *
* * *** * * *** * *
* *   * *   *     *
*  ** *  **   *****
*     * *   *     *
* ***** * * ***** *
*     * * * *     *
*  **** * * *  ** *
* *     * *   *   *
* * * * * *  ** * *
*       *  G      *
*******************
