*******************
*P          *     *
*** ******* * *** *
*   *       * *   *
* *** ****    * * *
*     *     * * * *
*** * * * * * * ***
*     * * * * *   *
* **  *** * *  *  *
*   *   * *       *
* * *** * ******* *
* *   *   * *     *
* * * *** * * *** *
* *G    *   *     *
*  **** *** ***** *
*     *   * *   * *
* * * * *** *   * *
*   *       * *   *
*******************
