*******************
*   *            P*
* * *** * * ***** *
* *         * *   *
* *****  ** * * ***
* *         *     *
* * *******   * ***
* * *G    * * *   *
* * * * * * * *   *
*   * * * *   * * *
* ***** ***  ** * *
*     *   *     * *
* *** *** ******* *
* *       *     * *
* *  ** * ** *  * *
*   *   *   *     *
* ****  *** *  ** *
*       *   *     *
*******************
