*******************
*             *   *
***  ********  ** *
*         *       *
* ***  * ** *******
*   *   *   *     *
*    ** * *** *** *
*     *    P*   * *
*  ** *** *****   *
*   *   *       * *
*** *** *** ***** *
*G*   *   * *   * *
* ***  ** *   *** *
*     * * * *   * *
* * **  * * *** * *
*         * *     *
* *** * * * * **  *
*     * *     *   *
*******************
