*******************
*                 *
*   *** *** * *** *
*           *     *
******* * *** *****
*      G*         *
* * * *********   *
* * * *       *   *
* *   *** * * * * *
* * *     *   *   *
* * *******   * ***
*       *     *   *
*   * * * ******* *
*     *   *     * *
* ********* * * * *
*   *   *P  * *   *
*** * * ***** **  *
*     *       *   *
*******************
