*******************
*   *             *
*** *  ********** *
*   *   *     *   *
* * *** * * *** ***
* *   * * * *   * *
*  *  * * * * * * *
*   *  P    * *   *
* * *   ****  * * *
* * * * *     * * *
* * *** **** ** * *
* *   * *       * *
* * * * * ******* *
*   *   *     *   *
*   **** **** * ***
*   *         *   *
**  * *** ******* *
*G    *           *
*******************
