*******************
* *         *     *
*    * ***  * **  *
* *P*     *       *
* * * * * * ***** *
*   * * * *       *
***** * * * ***  **
*         *       *
* * * * ***  ***  *
* *   *   *   *   *
* ** ****  ***  * *
* * *     *     * *
*   * * * * ***** *
* *   * * *   *   *
* *   *   *** *  **
* * * * * *G  *   *
* *   *** * ***** *
*   *       *     *
*******************
