*******************
*         *       *
* *   * * *   * * *
* *   * * * *   * *
*  ** * * * * * * *
* *     * * * *   *
* *** * *** * *  **
*   * *     * *G  *
*** * * ***   * ***
*P*     *     *   *
* *** * * * ***** *
*   *   * *     * *
* *    ** ***** * *
* * *     *   *   *
* * ****  * *   ***
* *     *         *
* ***** *** *** * *
*     *           *
*******************
