*******************
*     *           *
* *** *   * ***** *
*     * *   *     *
* * ***** * * *****
* *       * *     *
* ***** *** ***** *
*     *     *   * *
*  ** *** *** * * *
*   *   *     *G  *
***** * ***** *** *
*   * *     *     *
* *  ** * * * * ***
*       *         *
********  * ***** *
*       *         *
* ******   *** ** *
*  P              *
*******************
