*******************
*       *       * *
* * *** *** * * * *
* *   *     *P*   *
** ** **  *** *** *
*     * * *   * * *
* ** **   * **  * *
*   *       * *   *
***   * ** ** * ***
*   * *         * *
*  ****  **** *** *
* *           *   *
* *  ** ******* ***
* *   * *     *   *
* * * * *** * * * *
*   *    G  *   * *
****  *** *** *** *
*                 *
*******************
