*******************
*          G      *
* *****  **** *** *
* *     *   *   * *
* * *  *    * **  *
*   * *   *       *
***  **  ** * *****
*       *   * *   *
* * *** * *** * * *
*       *   *     *
* ***** **  ****  *
* *   *         * *
* *** ****  *** * *
*   * *         * *
*** * *  *  * * * *
*P  *       * * * *
* *******  ** *   *
*         *       *
*******************
