*******************
*        P        *
* ** ***  ******* *
*     *   *     * *
* *****  ** *** * *
*       *   *   * *
* ******  *** *** *
*         * *     *
**** ****** * *****
* *         *   * *
* * * * *** *   * *
*   * * * *   *   *
* *** * *  *   ** *
* *     *G  * *   *
* *   * *** * * ***
* * * *     * * * *
* * **** ** * * * *
* *               *
*******************
