*******************
*         *       *
*   *** * * ***** *
* * *   *   * *   *
* * * * *** *   ***
* *   *   *     * *
* ***** * *  **** *
* *     *G*       *
* * ***** *** *** *
* *             * *
* *****  **** * * *
*     * *     *   *
***** * * ** ** * *
*     * * *       *
* ** ** * *** *** *
*   *   *     *   *
***   *********  **
*   *  P          *
*******************
