*******************
*            P  * *
* ***   **** ** * *
*   *   *         *
* *  ****** ** ** *
* *   *   * *   * *
* *** * * * * * ***
*     * *     *   *
*** * * **     ****
* * *   * * * *   *
* * ***** * * * ***
* * *     *G  *   *
* * ***** *****   *
*       *     * * *
*  **** * * * *** *
*     *     *   * *
* * ***   * * *   *
* *         *     *
*******************
