*******************
*           *     *
* * ** **** * *** *
* *       *G      *
* * * *** ** ** ***
*   *   * *   * * *
* * * *   * *** * *
*     *   *     * *
* ***   * * ***** *
*     *   *     * *
* * * ********* * *
*     *   *     * *
*  **     * ***** *
*   *   * * *   * *
*  *****  * *   * *
* *   *P  * * *   *
*   * * ***   * * *
* * *   *     *   *
*******************
