*******************
*           *     *
* *** *** * * * * *
*         *   * * *
** ** ***   *** ***
*     *   *   *   *
* * * *  *  * *** *
* *   * *   *     *
* ***** * * ***** *
* *   *   * *   *P*
* *** ***** * * * *
*    G  *   * * * *
** **** *** * *** *
*     * *   *     *
*  ** * * *** *****
*   *     * * *   *
**  ***** * *   * *
*         *       *
*******************
