*******************
*           *     *
*******  **** * * *
*       *     * * *
* ** **** ***** ***
*       *   * *   *
* *** * *** * *** *
* *   *      G*   *
*** *  **  **** * *
*   *     *     * *
* * *** * * ***** *
*     * * *   *   *
*** * ******* * ***
* *   *       * * *
* *  ** * ***** * *
* *P      *   *   *
* ***** *     *** *
*         * *     *
*******************
