*******************
*   *   *     *   *
* ***   * *   * * *
* *   *   * *P  * *
* * ******* *** * *
* *   *   *       *
* *** * * *** *** *
*   *           * *
***  ** *** * * * *
*   *   * * * *   *
* * * **    * *** *
*   *   * * * *   *
* * ***   * * * ***
* *   *   * * *   *
*  ** * *** *  ** *
*      G      *   *
**  * * *  ***  * *
*       *       * *
*******************
