*******************
*                 *
* *** **** ** *** *
*   *           *P*
*  ** ***** ***   *
* *   *       * * *
*** * * ** ** *   *
*   *   * *   * * *
* *** **  * ****  *
*  G      * *     *
****  * *** * *** *
*       *   *   * *
* *** *   ***** ***
*       * *   *   *
* ***** * * * *** *
*   *   * *       *
* * ****  * ***** *
* *         *     *
*******************
