*******************
*     *     *     *
* *****  *  * **  *
*   *  G*   *     *
***   *** * *** * *
* *       *   * * *
*  *****  *** *** *
*           *     *
* ***    ***** ** *
*   * *     *     *
* * * * * * * *****
* *   *   *   *   *
* *** *** **** ** *
* *   *   *       *
*** *** ****  *** *
*   *   *P    * * *
*  ** *** * *** * *
*         *       *
*******************
