*******************
*     *        P  *
*** * * * *  **** *
*   * *   *   *   *
* *** *** * * * * *
*       *   *   * *
* * *** * * **** **
*         * *     *
* ****** **   **  *
*           * * * *
* ********* * * * *
*       *G  *     *
***** * * * *** * *
*   *   *     *   *
* **  * ***** *  **
*     *   *   *   *
* * **  *   * * * *
* *               *
*******************
