*******************
*   * *           *
* * * * * *** *** *
* * *   *   *   * *
*    **** *   * * *
* *       * *   * *
*  ******** ***** *
*     *   *       *
***** * * **** *  *
*     * *       * *
* ******* ****  * *
*     *   *       *
* *** * * * *******
*     * *   *    G*
*** * * *** * *   *
*   *P*   *   * * *
* *** *** *  **   *
*   *             *
*******************
