*******************
*       *   *     *
* * ***** * ***** *
* *           *   *
* ******* ***   * *
*     *       *   *
*** * * ***** *** *
* *   * *G        *
* * *** *  **** * *
*   *   *       * *
* *** * ******* * *
*     * *         *
* ***** * ******* *
*   *             *
* *  **** *  **   *
* * *   * *     * *
*   * *   * *** * *
*     *P    *     *
*******************
