*******************
*     *     *     *
* *** * *** ** ** *
*   *   * *      P*
* * **  * ***** * *
* *     *       * *
* *** * * * * **  *
* *     *         *
* *  ** ***  **** *
* * *             *
**  ***  ***  ** **
*   *  G    * *   *
* **    *** *** * *
*     *   *     * *
* * * * * ******* *
* * *           * *
*  ** ********* * *
*                 *
*******************
