*******************
*           *     *
* * * *** * **  * *
* * *     *     * *
*** *** *** *  ** *
*   *     * *   * *
* *** *** * *   * *
*     * *   * *G* *
* *** * * ***** * *
*   *             *
* *  * ****** *** *
* *     *     *   *
* ***** ***  ** * *
* *   *         * *
* * * *** *** *** *
*P* *       *     *
* * *** * *** *** *
*       * *       *
*******************
