*******************
*   *     *       *
*** * *** *** *** *
*   *       *   * *
* ***** **   **** *
*     * *         *
* * *   ********  *
* *   *         * *
* * ************* *
* *       *       *
*****   *   *******
*     * *   *     *
* ******* *** *** *
*     *   *     *P*
* *** * ******  * *
*   * *       * * *
*** *   * ***  ** *
*   *  G          *
*******************
