*******************
*                 *
*** * *** * ****  *
*   *           * *
* ************  * *
*       *    G  * *
* ** ** * ***** * *
*     *   *   *   *
***** ** ** * * * *
*   * *   * *   * *
* **  * *   *******
*     * * *       *
* *****   * * *** *
*       * *       *
***** * * ******* *
*   *   * *    P  *
* * ** **   * * * *
* *         *   * *
*******************
