*******************
*                 *
* * *** * ******* *
* *   * *        P*
* * *** * ******* *
*   *   *       * *
* * * * *** *** * *
* * * * *   * *   *
* * * * *  *  **  *
* * *   * *     * *
* * *** *   *** * *
* *   *   *   * * *
* *** * * * * *** *
* *  G* * * * *   *
* * * * ***** * ***
* * * *       *   *
* * *  * ** ** ** *
*   *     *       *
*******************
