*******************
*         *       *
* ******* * * *** *
*   *   * * *     *
*****   * *   *****
*   * *   * *   * *
* * * * **  * * * *
* *   * *   *G* * *
* * *** *  ** * * *
* *           * * *
* * * **** * ** * *
* * *   * *     * *
* * * * * ** **** *
* * * *           *
* * * * *** ***** *
* * * *   * *   * *
* * * **  * *   * *
*     *     *P*   *
*******************
