*******************
*                 *
* *****  ***  **  *
*     * * *     * *
* *** *   *  **   *
*   * *  G*   * * *
* **  *** *** * * *
* *     *     * * *
* * *** * * *** * *
* * *     *   *   *
*** * *******  ****
*   * *     *     *
* * * * * * ***** *
*   *   *   *     *
* * *** * * * *** *
* *   *P  * * * * *
* ***  * ** * * * *
*   *         *   *
*******************
