*******************
*     *           *
*   * **** *  ** **
* * *       *P*   *
* * *   *** * * * *
* *   *   *   * * *
* * * *** *****   *
* * *     *       *
**  * *  **  **** *
*   * *     * *   *
*  *  * ***** * ***
* * * *       *   *
* * * * ** ** *** *
* *   * *   *     *
* * *** *** * *** *
*     *G*         *
* * * * *  **** * *
*       *       * *
*******************
