*******************
*           *   * *
*** ***** * * * * *
*       * *   *   *
* * *** * * ***** *
* *    G*   *   * *
* * * * * * * * ***
*     *       *   *
* ***** * ** **   *
*   * * *   *   * *
* * * * *   * * * *
* * *     *     * *
* * * ***** **  * *
*   *       *   * *
* **  *** * ***** *
* *   *   *    P  *
* ***** **** **** *
*       *         *
*******************
