*******************
*          G*     *
******* *** **  ***
*       * *   *   *
* ******* *** *** *
* *     *         *
* * ***** * ***** *
* *       *     * *
*   * * ** *  *   *
*   *       *     *
* ******* * * *****
*     *   * *  P  *
*   * * **  * **  *
*   * *       *   *
* * * * * *********
* * * * *         *
* *   *   ******* *
*   *           * *
*******************
