*******************
*      P      *   *
* ******* *** * * *
*   *   * *     * *
* * * *  **  ***  *
* * * *   * *     *
**  * *** *   *** *
*   *   *   * *   *
* * *** ***** *****
*     *     *     *
*  *****  * ** ** *
* *         *     *
* * ** **** * * ***
*     *G*       * *
* *** *   * * *** *
*     *       *   *
* * **  *** * *  **
*           *     *
*******************
