*******************
*  G      *       *
*  ***  * * ***** *
*     * * * *  P  *
* * * * * * * * ***
* * * *   *   *   *
* * * *** * ***** *
* *     * * *     *
* ***** * * * *** *
*       *   *     *
* ******* *** *** *
* *   * *   *   * *
*  ** * *******  **
*   * *       *   *
*** * **** **  ** *
*   *       *     *
* * ******  * * * *
*           *   * *
*******************
