*******************
* *          G    *
* *  *** * **** * *
* *   *   *   * * *
* * * * *   * * * *
*P    * *   *   * *
* ***** ****  * * *
* *   *   *   * * *
*** *  *  * *** * *
*   * *   *   * * *
*  **   ******* * *
*   * * *     * * *
*** * * * * * * * *
*   *   * *   * * *
* *****   * *   * *
* *   *   *     * *
* * * ****  ****  *
*   *       *     *
*******************
