*******************
*                 *
* *   *** ******* *
* * * *       * * *
*** *   ***** * * *
*   * *P    *   * *
*   * *** * *** * *
* *   *   * *   * *
* * ***   * * *** *
* * *   * * * *   *
* * * *** * * * * *
*   * *     *   * *
* ***   * **   *  *
*   *         *  G*
*** *** * ******* *
* * *   *   *     *
* * * * *** * * ***
*     *   *       *
*******************
