*******************
*     *  P    *   *
* *** * * *** *   *
*   * * *   *   * *
****  *   * ****  *
*   * * * *   *   *
**  * * * *** * ***
*   * * * *   *   *
*  *  * * * ***** *
*     *   * *     *
* *******   *** ***
*         *   *   *
* *   * ***** *** *
* * * * *G  *   * *
* * *   * * *** * *
* * *   * *   * * *
* *** * * *** * * *
*     *   *     * *
*******************
