*******************
*       *    G*   *
*** *   * * * * * *
*     * *   *   * *
*  * ****** ***** *
*   *     *   *   *
* * * *  **** * ***
* *   * *     * * *
* *****   *** *** *
*   *       *   * *
****  * *** * * * *
*   * * *   *P* * *
* * * * * *** * * *
* *   * *     *   *
* ********** **** *
*     *   *     * *
* ***   * * * * * *
*   *   *   *     *
*******************
