*******************
* *   *       *   *
* * * *** *   *** *
* * *  G*         *
* * *** *** ***** *
*   * * *   *   * *
* * * * * **  * * *
* *   * * *     * *
* *** ***   * *** *
* *       * * *   *
*    *   ** * * ***
* *     *   * * * *
* ** **** *** * * *
* *     *   * *   *
*   * *   * * * * *
*     * * * *   * *
* ***   * * ***** *
*   *  P  *       *
*******************
