*******************
* *     *     *   *
* * *** * ***** * *
*     *   *   * *P*
* **  ***** *** * *
* *   *         * *
* * * * ********* *
* * *     *     * *
* * ******* ***   *
* * *       *     *
* *** ***** *  ** *
* *  G*     *     *
* * *** **  * *****
* *     *   *     *
* * ***** ******* *
* *     * *       *
* **  *** * *** ***
*         *       *
*******************
