*******************
*           *     *
* * **  *** *** * *
* * *     *     * *
* * *** * ******  *
* *   * *G    *   *
* ***    **** * * *
*   * *     * *   *
*** * ***** * * * *
* * *   * * * *   *
* * ***   * * * * *
* *   * *   *     *
* * **  ***** *****
*   *       *     *
*  ** * * * * *** *
* * *P* * *     * *
* * * *** ***** * *
*   *         *   *
*******************
