*******************
*         *       *
***** ***   ****  *
*     *   * *     *
* ****  *  ** *** *
*   *       * * * *
* * *  **** * * * *
*G  * *   *   *   *
* *** * * ** ** * *
*   *   * * *     *
* * **    * * **  *
* * *     * * *   *
**  * ** ** * * * *
*   * *       *   *
* **  * * * *** * *
*   * *   *     * *
* * * * * *** **  *
* *   *  P    *   *
*******************
