*******************
*     *         * *
***** *  **** * * *
*   *       *     *
*   ********* *** *
* *         * *   *
* *********** *  **
*     *       *   *
***** * * ******* *
*P      *   *   * *
* * *** *** * * * *
*   *       * *   *
* * * *   ***  ****
* *   * *    G*   *
* ***** *   *   * *
* *   * * * * * * *
* *** * * * * **  *
*     *           *
*******************
