*******************
* *         *  G  *
* * *** * * * *** *
* * *     * * *   *
* * *** * * *** ***
*   *   * *     * *
* *** **********  *
* *             * *
*    ****** * * * *
* *           * * *
* **  * ***** * * *
* *   *           *
* * *** *** ***** *
*   * *   * *     *
* *** *   * * *****
*  P*   * * * *   *
* * * **    *   * *
* *       *     * *
*******************
