*******************
*        P    *   *
* *** * **** ** * *
*   * * *         *
* * * *   * *******
*     *     * *   *
*  ** * **  * * * *
* * *     * *   * *
* * * *** * *** * *
*   *   * *   * * *
**** ** ***** * * *
*       *  G  * * *
* * ** *  ******* *
*             *   *
* * *** ***** * * *
* *   *   *   * * *
* ***   *   **  * *
*       *       * *
*******************
