*******************
*           *     *
* *** * **  * *** *
*   * * * * *     *
***** * * * * * * *
*     *   *   *  P*
* *** *** ***** * *
*   * *G  *   * * *
*** *** **  * * * *
* * *   * * *   * *
* * * *** * ****  *
* *   *   * * *   *
*   *** *** *   * *
* *   *     *   * *
*     *  ** * *** *
*   * *     *   * *
* *** ***** * * * *
*   *         *   *
*******************
