*******************
* *   *        G  *
* * * * *******   *
* *     *         *
*   ** **   * *** *
* *   *       *   *
* *** * *** *** ***
*   * * *       * *
*** * * * ******* *
*   * * *     *   *
* *** * ***** * * *
*         * *   * *
* * ***** * ****  *
* *   *   *   *   *
* * * * * *** * ***
* * *   * *       *
* * *** * * ***** *
*   *     *P      *
*******************
