*********
*AAAAAAA*
*A*****A*
*A*AAG*A*
*A*A***A*
*A*A*AAA*
***A*AA**
*AAPAAAA*
*********
