*********
*AAAAAAA*
**A*AA***
*AAPAA*A*
*AA**A*A*
*AAA*A*A*
*A*A**AA*
*A*AAGAA*
*********
