*************
*AAAAAAA*AAA*
*A*A*****A*A*
*A*GAAAA*AAA*
***A***A***A*
*AAAAAAA*AAA*
*A*******A*A*
*AAAAAAAAA*A*
*AA********A*
*AAAAAAA*AAA*
****AA*A*A*A*
*PAAAAAAAAAA*
*************
