*****
*AAG*
***A*
*PAA*
*****
