*********
*AAA*AAA*
***A*A*A*
*AAGAA*A*
*A***AA**
*A*AAA*A*
*A*A**AA*
*AAAAAAP*
*********
