*****
*PAA*
*A*A*
*G*A*
*****
