*************
*AAA*AAA*AAA*
*A*AAAAA*A*A*
*A*AAA*AAA*A*
*A***A*A***A*
*AAA*A*A*A*A*
*A*A*A*A*A*A*
*G*A*A*A*A*P*
***A*A*A*A*A*
*AAA*A*A*A*A*
*A****A**A*A*
*AAAAAAAAAAA*
*************
