*********
*AAAAAAA*
***A*A*A*
*PAAAAAA*
*A***A***
*AAA*A*G*
***A*A*A*
*AAAAAAA*
*********
