*********
*GAAAAAA*
**AA*A***
*AAA*A*A*
*A**AA*A*
*AAAAAAA*
*A*****A*
*AAPAAAA*
*********
