*************
*AAAAPAAAAAA*
****AA*A*A*A*
*AAAAA*A*A*A*
*A*******A*A*
*A*AAAAAAA*A*
*A*A*******A*
*AAAAA*AAAAA*
***A***A*A*A*
*A*A*AAA*AAA*
*A*AAA*****A*
*AAGAA*AAAAA*
*************
