*************
*AAAAGAAAAAA*
*A*A***A**AA*
*AAAAAAAAA*A*
*A***A*****A*
*A*AAA*AAA*A*
*A*A*A*A*A*A*
*AAA*A*A*AAA*
*A*A*A*A***A*
*AAA*A*PAA*A*
*A***A**AA*A*
*AAAAAAAAA*A*
*************
