***********
*AAAAA*AAP*
*A**AA*A*A*
*GAA*AAAAA*
***A*A*A***
*AAA*AAA*A*
*A**A**A*A*
*A*AAA*A*A*
*A*A*A***A*
*AAA*AAAAA*
***********
