*****
*AAG*
*A***
*PAA*
*****
