***********
*AAAAA*AAA*
*****A*A***
*PAAAA*A*A*
*A*****A*A*
*AAAAAAG*A*
*A**AA***A*
*AAA*AAAAA*
***A***A*A*
*AAAAAAA*A*
***********
