*****
*PAA*
***A*
*AAG*
*****
