***********
*AAPAAAAAA*
****AA*****
*AAA*AAAAA*
*A*A***A*A*
*A*AAG*A*A*
*A**AA***A*
*AAA*A*AAA*
**AAA**A*A*
*AAAAAAAAA*
***********
