*******
* *  G*
* * * *
* *   *
* * ***
*    P*
*******
