*************
*AAAAGAA*AAA*
*AAAA**A*A*A*
*A*AAA*A*AAA*
*A***A*A***A*
*A*A*A*AAA*A*
*A*AAA*****A*
*A*AAAAAAA*A*
*A*A**A**A*A*
*A*AAAAA*P*A*
*A*A***A*AAA*
*AAA*AAA*AAA*
*************
