*********
*AAA*AAA*
*A*AAA***
*P*AAA*A*
*AA****A*
*AAA*AAA*
***A*A*A*
*GAAAA*A*
*********
