***********
*AAGAAAA*A*
*A*AA**A*A*
*A*AAA*A*A*
*AAA*A*AAA*
*A*A*AAAAA*
*A***A***A*
*AAA*PAA*A*
*A*A**AA*A*
*AAAAAAA*A*
***********
