*****
*GAA*
*A***
*AAP*
*****
