*********
*A*AAPAA*
*A*AA**A*
*AAA*AAA*
*A**AA*A*
*AAAAA*G*
*A*****A*
*A*AAAAA*
*********
