*********
*G*AAAAA*
*A*A***A*
*AAAAA*A*
*A*****A*
*A*AAAAA*
*A**A****
*PAAAAAA*
*********
