*********
*A*AAA*A*
*A*A*A*A*
*AAG*A*A*
*A**AA*A*
*AAAAA*A*
**AA***A*
*AAAAAAP*
*********
