*************
*AAAAAAAAAAA*
*A*A*A*AAA*A*
*A*A*A*AAG*A*
*A*A*A*A*****
*A*AAA*AAAAA*
*A****A****A*
*P*AAAAAAAAA*
***A*A***A*A*
*AAA*A*A*A*A*
*A***A*A*AAA*
*AAAAA*AAAAA*
*************
