*************
*AAAAAAAAAAA*
*AA**A*AA**A*
*A*GAA*A*AAA*
*A*AAA*A*A*A*
*AAA*A*A*AAA*
***A*A*A*A*A*
*AAAAA*A*AAA*
*A**A*AAA**A*
*AAA*A*AAAAP*
***A*A*A*****
*AAAAA*AAAAA*
*************
