*************
*AAAAGAA*AAA*
***A*A*A**AA*
*AAAAA*AAA*A*
*A*A***A*A*A*
*A*AAAAA*A*A*
*A*A*A***A*A*
*A*A*AAA*A*A*
*AA**A*A*A*A*
*A*AAAAA*A*A*
*AAA*****A*A*
*PAAAAAAAAAA*
*************
