*************
*AAAAA*AAPAA*
***AAA*A*A*A*
*AAA*A*A*AAA*
*A**A****A***
*A*AAAAA*AAA*
*A*A***AA**A*
*A*A*A*AAA*G*
*A*A*A*A*A*A*
*A*A*A*AAA*A*
*A*A*AAA**AA*
*AAAAA*AAAAA*
*************
