*********
*A*AAAAA*
*AAAA**A*
*A*AAA*A*
*A*A*AAA*
*A*A*A*A*
*A*A*AAA*
*GAAAAAP*
*********
