***********
*AAA*AAA*A*
*A*AAA*A*A*
*AAP*A*AAA*
*AA**A***A*
*AAAAA*AAA*
***A*A*A***
*AAAAAAAAA*
*A*A*****A*
*AAAAAAAAG*
***********
