*************
*AAAAAAAAA*A*
***AA****AAA*
*AAAAAAAAAAA*
*A***A*******
*AAA*AAAAA*A*
*A*A***A*A*A*
*G*A*AAA*A*A*
*A*A*A*AAA*A*
*A*A*A*AAAAA*
*AAA*A*****A*
*A*AAAAAAPAA*
*************
