*********
*AAAAPAA*
*A**AA*A*
*AAA*AAA*
*AAA***A*
*AAAAA*G*
*A***A*A*
*AAAAAAA*
*********
