***************
* *           *
* * ***** *****
*   *   * *   *
* * * *** * * *
*     *     * *
*** *** * *** *
*   *       * *
* ******  *** *
* *       *  P*
* * * ****  * *
*  G*     * * *
** ****** * * *
*             *
***************
