***************
*     *       *
* * * ** *  * *
* * *         *
*** * * * *** *
*   *   *   * *
* **** * ** * *
*  G*     *   *
* *  ****   * *
* * *   *   * *
*** * * *** * *
*   * *     * *
* *** *** **  *
*     *    P  *
***************
