***************
*         *   *
***** *** * * *
*P    *   *   *
* ****  * * * *
* *     *   * *
* *   * **  * *
*   * *       *
* * * * ** ** *
* *           *
* * ********  *
*     *     * *
*  ** ***** * *
*   *  G      *
***************
