***************
*         *   *
* **** **** * *
*   *       * *
*** *** *** * *
*   *   *     *
* *** * * *** *
*   *       * *
*** * ******* *
* *   *   *G  *
* * * * * * * *
*P* *   *   * *
* * * ******  *
*             *
***************
