***************
*             *
* * ** **  ****
*       *     *
**** ** ** ** *
*     *     * *
*   ****  *** *
* *       *   *
* ****** ** * *
*P  *    G  * *
*** *    **** *
*       *     *
* *** * ***** *
*   *         *
***************
