***************
*P      * *   *
* * *** * * * *
* *     *   * *
* *  * ** *** *
* *   *   *   *
*  ** *  ** * *
*   * *       *
*** * ***  ** *
*   *G*   *   *
* * * * *** * *
*   *   *   * *
*  ****** *** *
*             *
***************
