***************
*     *P      *
* * **  * *** *
* *     * *   *
* *** * * *****
*       *     *
*** * * ** ** *
* * *         *
* * * ***** * *
*   * *     * *
* *** * ****  *
* *G  * *     *
* * * * ***** *
*   * *       *
***************
