***************
*   *         *
*  ** ******* *
*P*   *       *
* * * * ****  *
* *   * *     *
*   * * *******
*   *         *
* *** ******* *
* * *       * *
* * * ***** * *
* *     * * * *
* * *** * * * *
*   *G    *   *
***************
