***************
*     *    G  *
*** * * *** ***
*   * * * *   *
* ***** * * * *
*         *   *
* * * *** * ***
* * * *   *   *
*** * * * *** *
*   *   *   * *
* ****  * * ***
*   *  P* *   *
* * * *****   *
* *         * *
***************
