***************
*     * *    P*
* **  * * * * *
*   * *   * * *
*** *     * ***
* * * *   *   *
* * ******* * *
* *   *       *
* *** * *** * *
*   *   *   * *
* * * *** **  *
* *      G*   *
* *** ***** ***
*             *
***************
