***************
* *           *
* * *   *  ** *
*P  * *   * * *
* *** *****   *
* *   *      G*
* * **  ** ** *
* *   * *     *
* *** * *** ***
*     *   * * *
*** * *** * * *
*   *   *   * *
* *** * ***** *
*             *
***************
