***************
*   *   *    P*
* *** * *     *
* *   *   *   *
* * *** ***** *
*   *       * *
* ** **** *** *
*         *   *
* * ***** * * *
*G*       *   *
* * * * * * * *
*   * * *   * *
*** * ****  * *
*           * *
***************
