***************
*             *
* ***** * *** *
* *         * *
*   *******   *
*   *   *   * *
* * **  * *****
* *     *     *
* * * ***** * *
*   * *   * *G*
* *** *** * * *
* *   *       *
* * **  ** ** *
*P    *       *
***************
