***************
*   * *     * *
* * *   *** * *
*  P  *   * * *
* *** *** * * *
*   *   *   * *
*** * * * * * *
*   * *   *   *
* ***** ***** *
* *     *  G  *
* * ***** *** *
* * *     *   *
* * * *** * * *
*     *       *
***************
