***************
*             *
* *** * *******
*            P*
* *   *****   *
* *           *
* * * *** * * *
* * *     * * *
* * * *** *   *
* *   *   *   *
* ***** * *** *
*     *G* * * *
* * * * * *  **
*   *   *     *
***************
