***************
*         *   *
***** ******* *
*     *       *
* * *** * *****
* * *   *     *
* * * *** * * *
* * *   *   * *
* * **  *  ** *
* *   * * *   *
* * * * * * ***
*G  * * * *   *
* * *** ***** *
* *      P    *
***************
