***************
*   *       * *
*   *** ***   *
* *   * *   * *
* *** * *  ** *
* *G      *   *
* *****   * ***
*     *     * *
* ***  **** * *
*   *     * * *
* * *   * *** *
* * * * *     *
* * * * ***   *
*   *P        *
***************
