***************
*    G        *
* * * ******  *
* * * *       *
*** * * * *   *
*   * * * * * *
* *** *** * * *
* *     * *   *
* *****   **  *
*       *   * *
********* * * *
*     *  P  * *
* *** * * *** *
*   *   *     *
***************
