***************
*   * *   *   *
***   *   * * *
*   *   * * * *
* *  **** *** *
*P*   * *G    *
* *** * ** ** *
* *           *
* **** ** *****
*   *         *
* * * *  ** * *
* * * *     * *
* * * *** *** *
*         *   *
***************
