***************
*P            *
***** *  * ** *
*         *   *
* ** **** * ***
* *     * *   *
* *  *  * *** *
*     * *     *
* * * *   *  **
*     *   *   *
*  *  * * * * *
*       * *G* *
* * * *** *** *
*             *
***************
