***************
*             *
*  * *****  * *
* *   *G  * * *
* * * * * * * *
* * * * *     *
* * * * * *****
* * *   * *   *
* * * * *   ***
* * *   * * * *
* * **  * * * *
*P*   * * *   *
* * *   * *** *
*   * *       *
***************
