***************
*       *P    *
* ***  **   * *
*       * * * *
* ***** * *   *
*     * * * * *
***** * * * * *
*     * *   * *
* ****  ***** *
*     *    G  *
* *** *********
*   *         *
***   ***** * *
*     *       *
***************
