***************
* *P  *       *
* * * *   **  *
*   *     *   *
**    ***** * *
*     *     * *
* * **  ***** *
* *   *   *   *
* *** * * *** *
*   * * *     *
*** * ******* *
* * *       * *
* * * ** ** * *
*  G  *       *
***************
