***************
*G    *       *
* *** * ***** *
*   * * * *   *
* * * * * * ***
* * *   * *   *
***  **** *** *
*             *
* ***** *******
*     *     * *
***** *** * * *
*   *     * * *
* ********* * *
*  P          *
***************
