***************
*     *       *
* * *   ***** *
* * *   *     *
* * * *** *****
*   *         *
* *** **** ** *
*   *   *   * *
*   *** *  ** *
* *G        * *
* ****** *  * *
* *   *   *  P*
*   * * * *****
*       *     *
***************
