***************
*   *   *     *
* * *   * * ***
* * * *   *  G*
* *** ******* *
*   *       * *
* * *** ***** *
* *     *     *
*  * **** *** *
* *     *     *
* * * ******* *
*   *       *P*
*** *** * *   *
*       * *   *
***************
