***************
*             *
* * ****  *** *
*   *     * * *
***** ***** * *
*     *P      *
* *************
* *           *
* * *** *** * *
*     *     * *
*** * * * * * *
* *     *     *
* *   ******  *
*     *  G    *
***************
