***************
*        G*   *
* ***** *** * *
*   *       * *
* * * ***** * *
* *   *     * *
* *****   **  *
*     *     * *
****  *       *
*     * * *  P*
*  **** * *   *
*     * *   * *
* ***   ***** *
*     *       *
***************
