***************
*       *  P  *
***** * *  ** *
*   * * * *   *
* * * * * *   *
* *   * * *   *
*  * ** ***** *
* *     *     *
* * * *** * * *
* * *   *     *
* * *** *** * *
*   * *     * *
* * * *   *** *
*   *  G  *   *
***************
