***************
* *  P        *
* *** **  *** *
*     * *     *
***** * ***** *
*           * *
* * **** * ** *
*             *
* *********** *
*      G      *
***** ***** * *
*   *       * *
* * ********* *
* *           *
***************
