***************
*     *       *
* *** * *** * *
*P*   *       *
* * * ***  ** *
*   *     *   *
*** ** ***    *
* * *   *   * *
* * *** * * ***
*       * *   *
*   * * * * * *
* *   * *   *G*
* * *** ***** *
*           * *
***************
