***************
*G    *       *
* * * *** * * *
* * *       * *
*** * * ***** *
*     *  P*   *
* *** * * * * *
* * * * * *   *
* * * *** * ***
* *       *   *
* * ******* ***
* * *         *
*   * **** ** *
*           * *
***************
