***************
*P*      G    *
* * ******* * *
*         *   *
* ********* * *
*       *   * *
* *  ** * *** *
* * *       * *
* *     *** * *
* * *     *   *
* * *****   ***
* *       * * *
* * * * *** * *
* *           *
***************
