***************
*        P  * *
* ** *****  * *
*         *   *
************* *
*   *       * *
*** * ***** * *
*   *     * * *
* *** *** * * *
*   *G  * *   *
* * * * * *** *
* * * * * *   *
* * * * * *** *
* *   *       *
***************
