***************
* *           *
* * ******* * *
* *          P*
* *** *** *** *
*       *   * *
****  * *** * *
*     *     * *
* ** ** *** * *
*       *     *
* ******** ** *
* *   *       *
* * *  **** * *
*  G*         *
***************
