***************
*       *     *
* *** * * * * *
*     *   *G* *
***** *** * * *
*   *   *   * *
* *  ** *  ****
* *     *     *
* **  ** **** *
*   *         *
* *** *****   *
* *   * * * *P*
* * * * * * * *
*       *     *
***************
