***************
*  P*     *   *
*   * * * *** *
* * *   *     *
* * * *  ***  *
* *   *   *   *
*  ******  ****
* *     *     *
* * *   ** ** *
* *   *     * *
* *** * ***   *
* *   *G*     *
* *   * *** * *
*   * *     * *
***************
