***************
*             *
*** * * ***** *
*     *   *   *
* *****   *** *
*G*     * * * *
*   *** * *   *
*     * *   * *
******  ***** *
*       *    P*
* *** *** *****
* *   *   *   *
* * *   ***   *
*   *       * *
***************
