***************
*  P*   *     *
* **  * * *** *
*             *
* ****** *  * *
*   *     * * *
*** * * * * ***
*     * * *   *
******  * * * *
*     * * * * *
****  * * *** *
*   *   * *  G*
* *  **** * * *
* *         * *
***************
