***************
* *       *G  *
* * * *** * ***
*   * *   *   *
* *   * ***** *
*   *       * *
* *** ****  * *
*   *   *   * *
* ***** * *** *
*       *   *P*
* ********* * *
*   *     *   *
* * * *** * * *
* *       *   *
***************
