***************
*P    *       *
* * *** ***** *
* * *         *
* * * *** *****
* * * *   *   *
**  *   *** * *
*   * *G*   * *
* * * * * *** *
*   *   *   * *
* * * * * * * *
*     * * * * *
* * * ***** * *
*           * *
***************
