***************
*         *   *
* *** *** * * *
*   *   * *   *
**  *** * * * *
* *   * * * * *
* **  * * *** *
*   * * *     *
* *** * *   * *
*  P  *     * *
* *** * ***** *
* *   * *    G*
* *** * * * * *
*   *   *     *
***************
