***************
*     * *     *
* *** * ***** *
*       *   *G*
* * *** * * * *
*   *   *     *
*  ** ***  ** *
*P*   *     * *
* * *** *** ***
*         *   *
* *** ***** * *
*   * *   * * *
*** *** * *** *
*       *     *
***************
