***************
*           * *
* *** ***** * *
*       * *   *
* *  **   *** *
*   *   *G    *
***** *** *** *
*     *   *   *
* ** **** *   *
*       * * * *
*  ** * * *** *
*     * *   * *
* * *** * *   *
* *P    *     *
***************
