***************
*           * *
* * * *****   *
*   *     *   *
*** *   *  ** *
*P*   *       *
* *** ***** ***
*         * * *
* ***** *   * *
*     *    G  *
* *** ******* *
*   *       * *
* * *** * * * *
*     *   *   *
***************
