***************
*G          * *
* ********* * *
* *   *   * * *
* * * *  ** * *
* * *   *     *
* * ***** *** *
* *           *
* * ******** **
* *   *  P    *
* *** * * *** *
*       *   * *
* ****** **  **
*             *
***************
