***************
*     *P      *
*  *  * * *** *
* *   * *   * *
* ***** * * * *
*       * *   *
*  ****** * ***
*     *     * *
***** * ***** *
*     *     * *
* ********* * *
*   *     *   *
*** ***   *** *
*G            *
***************
