***************
*            G*
**** ** * *** *
*       *   * *
*  ** ** ** * *
*     *     * *
* * *** ***** *
* *   *     * *
*  ******   * *
* *         * *
* * ** * **** *
*      P  *   *
* *******   * *
*         * * *
***************
