***************
*   *   *     *
* * * * ****  *
* *P          *
* ****  ** ** *
* *         * *
* ********* * *
*   *     * * *
*** *  ** * * *
*   * *   *   *
* *   ***** ***
* *   *  G*   *
* *** * * **  *
*       *     *
***************
