***************
*        G*   *
*   ****  *** *
* *   *       *
*****   *** * *
*     *   *   *
* *** *** * ***
*   * *   * * *
*** * * * * * *
*P      *   * *
* ***** * * * *
*   *   * *   *
* * ***** *   *
*         *   *
***************
