***************
* * *         *
* * * ***** * *
* *   *   * * *
* * ** ** * ***
*        P*   *
* *********** *
*   *  G*   * *
*** * *   * * *
*   * *   * * *
*  ** ***** * *
*   *   *   * *
**  *** *  *  *
*       *     *
***************
