***************
*           * *
*** *****   * *
*         *   *
*******  ** * *
*       * *   *
* ***** * * ***
*P    *  G*   *
* *** ******* *
* *   *     * *
* * *** ***   *
* *     *   * *
* **** **  *  *
*       *     *
***************
