***************
*      G*     *
* ***** ***** *
*             *
* * * * ***** *
* *     *   * *
*** ** ** *   *
*       * * * *
* * * * * * ***
*     * *     *
* **  * *  ** *
*   * *   *   *
***   ***** * *
*   *  P    * *
***************
