***************
*             *
***  * ****   *
*   *       * *
* * * *********
*   *   *G*   *
* ***** *   * *
*       *   * *
* * * * *** * *
* *       * * *
*   * ***  ** *
* * *     *   *
*   * ***** * *
*P*         * *
***************
