***************
*       *     *
***** * *   ***
*P    * * *   *
* ***** *** * *
*   * *     * *
*** * **  * * *
*   *   * *   *
* ***** * * * *
* *   * *   * *
* *  **  ** * *
* * *   *G    *
*   * * * *   *
*   * *       *
***************
