***************
* *G          *
* * ********* *
*   *     *   *
* **  *   * ***
* *   * * *   *
* * *** ***** *
* * *       * *
**    *** * * *
*   *  P* * * *
*  **       * *
*     * * * * *
******* * *   *
*             *
***************
