***************
*     *       *
* * ***   *** *
* * *   *P*   *
* * *  ** *****
* * * *       *
*   * *  * * **
* * * *     * *
* * * ***   * *
* * *         *
* ********  * *
*     *   *   *
* * ***   *** *
* *      G    *
***************
