***************
*   *    P    *
* *    **** * *
*   * * *     *
*** * * * *****
* * *   * *   *
* *  ** * * * *
*   *   *   * *
* * * ******* *
*   *   *     *
*  ** * * *** *
* *     *     *
*   * *** *  **
*   *     *  G*
***************
