***************
*             *
* *********   *
*   *P      * *
* *** *** *****
*     *   *   *
* *  *  *** * *
* *   *   * * *
* * * ***** * *
*   *       * *
* * ***** *** *
*   *  G    * *
*  *  ******* *
*   *         *
***************
