***************
*   *         *
* * * *** *****
* * *         *
* * * ***  ** *
* *P  *   * * *
*  **** * * * *
* * *   *   * *
* * * * **  * *
*   * *    G* *
* *** * *** * *
* *       *   *
*   * *** *** *
* *       *   *
***************
