***************
*   *       * *
* * *   * * * *
* *     *     *
* * ** ** *** *
*       *G*   *
*  **** * * ***
*     *   *   *
* * *  ****** *
*     *       *
* *** * *******
* * *   *     *
* * ***   *** *
*          P  *
***************
