***************
*     *       *
* *** ***  ** *
* *      G  * *
* ***** * * * *
*   * *       *
* * * *** *****
* *       *   *
*** * * *   * *
*   *   *   * *
* *******  ** *
*         *   *
* ** * **** ***
*    P        *
***************
