***************
*   *     *   *
* *** * *  ** *
* *   * *     *
* * ***  **** *
* * * * *  G  *
* * * * *** * *
* * * *   *   *
*   * *** * ***
* * *   * * * *
* * *** * * * *
*       * * * *
* *** *** * * *
*P  *     *   *
***************
