***************
*     *       *
* * * * * *** *
*   *   *   * *
*  ******** * *
*P*       * * *
* * ** ** * ***
* *   *       *
* *****   *** *
*   *     *   *
*** * * *** ***
* *   * *   * *
*  ****  **** *
*    G        *
***************
