***************
*   *         *
* * **  ****  *
* *   *   *P  *
* **  *** * * *
*   *     * * *
* * *** * *   *
* *     * *   *
* ****  *** * *
*  G* *     * *
*** * ***** * *
* *       *   *
* *** * *** * *
*       *   * *
***************
