***************
*           * *
* ********* * *
* *     *   * *
* *  ****  ** *
*    G    *   *
* * * * ***   *
* *         * *
* ** ******** *
* *           *
* * *   *** ***
* * *         *
* * * *** *****
*P            *
***************
