***************
*   *       * *
* * * ***** * *
*           * *
* ** ** * *** *
*       *P    *
* ***** ***** *
* * *   *     *
* *   * *******
*   * * *     *
*** * * ***** *
*   * * *     *
* * * *** ** **
*          G  *
***************
