***************
* *    P    * *
* * ***** * * *
* * * *   *   *
* * * *  ** * *
* * * *       *
* * * *** *****
*   *   *     *
* *   *   *** *
*  G* *     * *
* ** **** *** *
*     *   * * *
* *** * * * * *
*       * *   *
***************
