***************
*       *     *
***** * *  ** *
*   *         *
*** * *  **  **
*P  * *   *   *
* *** **  * * *
*     *     * *
******  *** * *
* *     *  G* *
*    ** * * * *
* *   * * *   *
*   * * * *   *
*     *     * *
***************
