***************
*     *       *
* * * * ***** *
* * *   *     *
*** *** * *****
*   *   *   * *
* * * * **    *
*   *       * *
*   **  * *** *
* * *   * *   *
* * * *** * * *
* * *       *G*
*     ***** * *
*P  *       * *
***************
