***************
*P*     *     *
* * *** * *** *
* *   *   *   *
* **  ****  * *
*   *     * * *
* *** * * *** *
* *     *   * *
* * ***** * * *
* *   *   *G  *
* *** *  **** *
*     * * *   *
*   *** * * ***
*             *
***************
