***************
*            P*
* * *** * *** *
* *     *     *
* * * *** * ***
* *     * *   *
* *  ** * *****
*   * *G  *   *
* ***   * *** *
*     *   *   *
***** ***** * *
*   * *     * *
* * *  ** *** *
*         *   *
***************
