***************
*         *   *
* *** ***  ** *
* *   *P*     *
* * *** ***** *
* * *   *     *
*** * *** *****
*   *         *
* *** *  **** *
* *   *     * *
***  **** * * *
*   * *   * * *
* *** * **  * *
*     *      G*
***************
