***************
*P      *     *
* * *** *   * *
* * *   *   * *
* * * **  * * *
* * * *   *   *
*** * * ***   *
*   *   *     *
* ***** * *** *
* *       *  G*
* * *** ***   *
* *   *       *
* *** *** *** *
*         *   *
***************
