***************
*             *
* * * ******* *
* * *   *     *
*** * * * *** *
*P  * *   *   *
* *** ***** ***
*   *     * * *
*   * * * * * *
* * *   * *   *
* * * *** **  *
* * * *    G  *
* * * * *** * *
* *   *   *   *
***************
