***************
*             *
* ***** ** ** *
* *   * *   * *
* *  ** * * * *
*   *   * *   *
**    *** *** *
*  P* *   *G  *
* * *   ***   *
*   *   *   * *
* * ******* * *
*   *     *   *
* *** *** *** *
*     *       *
***************
