***************
*             *
* *** ***** * *
* *   *   *P* *
* * *** * * * *
* *   * * * * *
* * * * * * * *
* * * * * * * *
* * * * *** * *
*   *   *     *
** * ***  * ***
*      G*   * *
* * *  ** *** *
*   *         *
***************
