***************
* *   *     * *
* *   * *   * *
*   *G    *   *
* * ********* *
* *         * *
* ******  * * *
*     *       *
*    ** *** * *
* * *   * * * *
* * *  ** * * *
*  P      *   *
* * ***** *****
* *           *
***************
