***************
*      G  *   *
* *** *** *** *
*   *   *     *
*   **  ***** *
* *   *       *
* * *** *** * *
*   *   *   * *
* *** * * * * *
*P*   *   * * *
* *  ** *** ***
* *       *   *
*  ********** *
*       *     *
***************
