***************
*   *         *
* * * *** * * *
* *   *     * *
* * *** * *****
* *    G* *   *
* *** * ***   *
*   * *     * *
* *   * * *** *
* *   *   *   *
*   * ***** * *
* * *         *
*   *** ***** *
* *   *      P*
***************
