***************
*             *
* **  *  **** *
*     * * *   *
* * *** *   ***
* *       * * *
* ****** *  * *
* *   *G      *
* * ********* *
* *         * *
*  *  * * * * *
*   * * *   * *
*** *** * *** *
*P      *     *
***************
