***************
*           * *
*******  ** * *
*       *   * *
* ******* **  *
*       *   * *
*** * ****  * *
*   * *   * * *
*  ** * * * * *
* *     * * * *
* * ***** * * *
*   *       *P*
* * * ***** * *
* * *G        *
***************
