***************
*             *
* * ***** *** *
*       *     *
* ***   **  ***
*      P  *   *
****** ****** *
*             *
* *  *** ** * *
* * *         *
*   *** * *****
* *     *     *
* * ******* * *
*   *G        *
***************
