***************
*             *
*   * * *** * *
*P    * *   * *
* *** ***  ** *
* * *     * * *
*   ******* * *
* * *   *     *
*   * * * *****
*     * * *   *
* * **  * *** *
* *     * *   *
*    ** * * * *
*   *  G    * *
***************
