***************
*             *
* ***  *** ** *
*           * *
*** *** *** * *
*   *   * *P* *
* *** *** *** *
*             *
* ***** ***** *
*   *   *     *
*** ****  *** *
* *       *   *
* *********  **
*            G*
***************
