***************
*           * *
*  ** *****   *
*       *   * *
******* * *** *
*       *     *
* **** *****  *
*   *G  *   * *
* *   * ***   *
* *   *     * *
* * ***   *** *
*   *        P*
* * * *** *****
* *   *       *
***************
