***************
*          P* *
* *** * *** * *
*   * * * *   *
***   * * *** *
*   * *   *   *
* *** *****  **
* *   *   *   *
* * *   * *** *
* *     *     *
*  ** * * *****
* *   * *     *
* * * ***** * *
*   *      G  *
***************
