***************
*     *     * *
* * * * ** ** *
* * *   *     *
* * * ***** * *
* *       *   *
* * * **  * ***
* *P* *   *G  *
* * * * ***** *
* * *   *     *
* * * * * *****
* * *   *     *
* * *** ***** *
*   *         *
***************
