***************
*     *    P* *
* *****  ** * *
*   *   *   * *
*   * *** * * *
* *   *   *   *
* * *** *** * *
*           * *
* ******* * * *
*        G* * *
*   ***   *** *
*   * * *     *
*  *  * *******
*             *
***************
