***************
*         *   *
* ***   *** * *
*   * * *   * *
*** * * * *** *
*         * * *
* ***  * ** * *
*   *G  *     *
*** *** * *****
*   *     *   *
* * ***** *** *
* * *     *   *
*   *  * *    *
*           *P*
***************
