***************
*             *
*   ***   * * *
* * *     * * *
*  *  *** * ***
*G    *       *
* ***** ****  *
*   * *  P    *
*   * ** ** ***
* * *     *   *
* *   **  *** *
* *     *     *
* ***** *** * *
*             *
***************
