***************
*       *     *
* *** * * *****
* *     *     *
*** *** ***** *
*   * *       *
* *** * ****  *
*P*    G*     *
* ****  * **  *
*     *     * *
** ** ***** * *
*   *   *     *
* * ***   *** *
*       *     *
***************
