***************
*         *   *
* ***  **** * *
*         * * *
* **** ** * * *
*P*   * * * * *
* * * * * * * *
* * *   *   * *
* * ****** ** *
* *         * *
*  * ** *** * *
* *       * * *
* * *  **  ** *
*         *G  *
***************
