***************
*     *       *
* ***   *** * *
*     * * *   *
* *** *** * ***
* *   *     * *
* * *   ***** *
* * * *       *
* * *     *** *
* *   * * *  P*
*  ** * * * * *
*    G* * * * *
* * * * *** * *
* *           *
***************
