***************
*             *
*  *********  *
*   *G  *     *
*** * *  **** *
*   * *     * *
* **  ***** ***
*         *   *
* *  **** *** *
* * *       * *
* *** ******* *
*   *P  *   * *
* *** * * * * *
*         *   *
***************
