***************
*P      *     *
* * * * ***** *
* *   *       *
* ****** **** *
*         *   *
* * *  ** *  **
*         *   *
***** * * **  *
*   * * * *   *
* * *** * * ***
* *  G    * * *
* ** ***    * *
*             *
***************
