***************
*       *     *
* ******* *** *
*         *G  *
***** * * *  **
*     *     * *
* ***** * *** *
* *P    *     *
* * ********* *
*   *         *
* *** ** * ** *
*     *   *   *
**** ** * *  **
*             *
***************
