*********
*P      *
*** *** *
*   *   *
* **  ***
*   * * *
* * *** *
*G*     *
*********
