*********
*       *
* *** * *
*G  * * *
* * * ***
* *     *
* * * * *
* *  P  *
*********
