*********
*AAAAAAA*
*A****AA*
*A*A*PAA*
*A*A*A***
*A*AAA*A*
*A*****A*
*AAGAAAA*
*********
