*********
*AAAAAAA*
***A***A*
*A*AAGAA*
*A*A*****
*A*AAA*A*
*AA*AA*A*
*AAPAAAA*
*********
