*********
*A*AAPAA*
*A*A*A*A*
*A*A*AAA*
*A*A*A*A*
*A*AAA*A*
*A**A**A*
*GAAAAAA*
*********
