*********
*AAAAAAP*
*A*A***A*
*A*AAA*A*
***A*A*A*
*AAA*GAA*
*A**A**A*
*AAAAAAA*
*********
