*********
*A*AAAAA*
*A*A***A*
*AAA*GAA*
*A***A***
*A*A*AAA*
*A*A*A*A*
*P*AAAAA*
*********
