*********
*A*AAAAA*
*A*A*****
*AAA*AAG*
*A***A*A*
*A*AAA*A*
*A*A**AA*
*AAA*AAP*
*********
