*********
*A*AAAAA*
*A*A***A*
*AAA*AAP*
*A*******
*A*AAAAA*
*AA**A*A*
*AAAAA*G*
*********
