*********
*     *P*
*  ** * *
* *     *
* *  ** *
* *   *G*
* ***** *
*       *
*********
