*********
*AAA*AAA*
*A***AAA*
*GAAAA*P*
*A****AA*
*A*A*AAA*
*A*A*A*A*
*AAA*AAA*
*********
