*********
*PAAAAAA*
***A*AA**
*AAAAA*G*
*A*****A*
*AAAAAAA*
*A*******
*AAAAAAA*
*********
