*********
*A*AAAAA*
*A*A***A*
*AAPAA*A*
*AA**A*A*
*A*AAA*A*
*A*A***A*
*G*AAAAA*
*********
