*********
*GAAAAAA*
*A*******
*AAAAAAA*
*A*A*****
*A*AAPAA*
*A***A*A*
*AAAAA*A*
*********
