*********
*    G* *
****  * *
* *   * *
* * *** *
*   *P  *
* *** * *
*     * *
*********
