*********
*AAAAP*A*
*A*A*A*A*
*A*AAAAA*
*A*A**A**
*A*AAAAG*
*A****AA*
*AAA*AAA*
*********
