*********
*AAAAAAA*
*A***A***
*AAAAAAA*
*****A*A*
*GAA*A*A*
*A*****A*
*AAAAAAP*
*********
