*********
* *     *
*   *** *
*   *  G*
*  **   *
*P*   * *
*** * * *
*       *
*********
