*********
*AAAAAAA*
****A**A*
*PAAAAAA*
*A*AA****
*AAAAAAG*
*A*****A*
*AAAAA*A*
*********
