*********
*AAA*A*P*
***AAA*A*
*GAA*A*A*
*A*A*A*A*
*A*A*A*A*
*AA**A*A*
*AAAAAAA*
*********
