*********
*AAA*AAA*
*A*****A*
*AAAAAAG*
*A*******
*A*AAAAA*
*A***A*A*
*AAAAA*P*
*********
