*********
*AAAAPAA*
****A**A*
*AAAAAAA*
*AA*A**A*
*AAAAAAG*
*A***A*A*
*AAA*A*A*
*********
