*********
*AAAAAAA*
*A*****A*
*GAA*A*A*
**AA*A*A*
*A*AAA*A*
*A**A**A*
*AAPAAAA*
*********
