*********
*AAAAA*A*
*A*A*A*A*
*P*AAA*G*
*A*****A*
*AAAAA*A*
*A*AAA*A*
*AAA*AAA*
*********
