*********
*AAAAAAA*
*AA***AA*
*AAAAG*A*
*AA**A***
*AAA*AAA*
*A*A***A*
*AAA*AAP*
*********
