*********
*AAAAAAG*
*A**AA*A*
*AAA*AAA*
**AA*****
*AAA*AAA*
*A*A*A*A*
*PAAAAAA*
*********
