*********
*       *
* ***   *
*   *   *
* * *****
*      G*
* ***   *
*P  *   *
*********
