*********
*  G    *
* ***   *
*     * *
* * *** *
* *   * *
* *** ***
*   *P  *
*********
