*********
*AAG*AAA*
*A***A*A*
*A*AAA*A*
*A*A**AA*
*AAPAAAA*
*A**A****
*AAAAAAA*
*********
