*********
*   *   *
***   * *
* * *  G*
* * * * *
* *   * *
* ***** *
*      P*
*********
