*********
*       *
* * * * *
* *G    *
* *** ***
* *   * *
* ***** *
*  P    *
*********
