*********
*AAAAAAA*
*A***A***
*A*A*AAG*
*A*A*****
*AAAAAAA*
****AA*A*
*AAAAPAA*
*********
