*********
*AAA*AAA*
*AAA***A*
*A*AAAAP*
*AAA***A*
*G*A*AAA*
*A***A*A*
*AAAAA*A*
*********
