*********
*      G*
* * *****
*P*     *
* ***** *
* * * * *
* *   * *
*   *   *
*********
