*********
*AAA*AAP*
*AAA*A*A*
*AAAAA*A*
*A*****A*
*AAA*AAA*
*A*A*A***
*A*G*AAA*
*********
