*********
*AAAAAAP*
*****A*A*
*AAA*A*A*
*A*A*AAA*
*A*GAA*A*
*A****A**
*AAAAAAA*
*********
