*********
*AAAAAAA*
*A*****A*
*AAAAG*A*
*A*****A*
*A*AAA*A*
***A*A*A*
*AAPAAAA*
*********
