*********
*PAAAAAA*
*A***A***
*AAA*AAA*
*A*****A*
*A*AAGAA*
*A*A*A***
*AAAAAAA*
*********
