*********
*       *
*  ** * *
*   * * *
****  * *
*P*     *
* * *** *
*   *  G*
*********
