*********
*       *
* ***** *
* *  P  *
* *  *  *
*   *   *
* *** * *
*    G* *
*********
