*********
*AAP*AAA*
*A***A*A*
*AAAAA*A*
*A*****A*
*A*AAAAA*
*A*A***A*
*AAGAAAA*
*********
