*********
*AAAAP*A*
*A*****A*
*A*AAAAA*
*A*A***A*
*A*G*A*A*
*A*A*A*A*
*AAA*AAA*
*********
