*********
*AAAAAAA*
**AAA**A*
*AAG*AAA*
*A**A**A*
*A*AAA*A*
*AA**A*A*
*AAAAP*A*
*********
