*********
*AAAAAAA*
*AA*AA*A*
*A*AAP*A*
*A*A***A*
*A*A*AAA*
*A*A*A*A*
*G*AAAAA*
*********
