*********
*  G*   *
*** * * *
*   * * *
* *** * *
*   * * *
* * *** *
* *  P  *
*********
