*********
*PAAAA*A*
**AA*AAA*
*AAA*A*G*
*A***A*A*
*AAA*A*A*
*A*A*A*A*
*A*A*AAA*
*********
