*********
*GAAAAAA*
***A*AA**
*AAAAA*A*
*A*****A*
*PAAAA*A*
*A***A*A*
*AAA*AAA*
*********
