*********
*AAAAAAA*
*****A*A*
*AAAAGAA*
*A*******
*AAA*AAA*
*A*A***A*
*AAPAAAA*
*********
