*********
*P*     *
* * *** *
*   *   *
***** * *
*     * *
* *** * *
*    G* *
*********
