*********
*AAAAA*A*
***A*AAA*
*GAAAAAA*
*A**A**A*
*A*A*AAP*
***A*A*A*
*AAAAAAA*
*********
