*********
*A*AAAAA*
*A*A***A*
*A*A*AAP*
*A*A*A***
*AAA*AAA*
*AAAAAAA*
*AAAAAAG*
*********
