*********
*AAAAA*A*
*A***A*A*
*A*A*AAP*
*AAA***A*
*A*AAAAA*
*A**AA***
*AAA*GAA*
*********
