*********
*AAA*GAA*
*A*A*A*A*
*A*AAA*A*
*A*A***A*
*A*AAA*A*
*A*A*A*A*
*AAAAPAA*
*********
