*********
*AAAAGAA*
*AAA*A***
*A*A*AAA*
*A**AA*A*
*A*AAA*P*
*A*****A*
*AAAAAAA*
*********
