*********
*PAAAAAA*
*A*A*A***
*A*A*AAA*
*A*A*****
*A*A*GAA*
*A*A***A*
*AAAAAAA*
*********
