*********
*AAA*AAP*
*A*AAAAA*
*G*AAA*A*
******AA*
*AAAAAAA*
*A*A*A*A*
*A*AAAAA*
*********
