*********
*G  *   *
***   * *
* * * *P*
* * *** *
*   *   *
* *** * *
*     * *
*********
