*********
*AAAAP*A*
*A***A*A*
*AAAAA*A*
*A****AA*
*AAAAA*A*
*****AAA*
*GAAAAAA*
*********
