*********
*A*AAAAA*
*A*A*AA**
*A*A*GAA*
*AAA***A*
*A*AAA*A*
*A*A***A*
*AAP*AAA*
*********
