*********
*AAGAAAA*
****A**A*
*AAAAAAA*
*A**A**A*
*P*AAAAA*
*A*A***A*
*AAAAAAA*
*********
