*********
*  G    *
* * *****
* *     *
* ***** *
*     * *
***** ***
*      P*
*********
