*********
*AAPAA*A*
*A***A*A*
*AAA*A*A*
*****A*A*
*AAA*G*A*
*A*A*A*A*
*A*AAAAA*
*********
