*********
*AAA*AAP*
*A**AA*A*
*AAA*A*A*
*A*A***A*
*AAA*AAA*
*A***A***
*AAAAAAG*
*********
