*********
*AAAAAAA*
*A*A*****
*A*AAAAP*
*******A*
*AAAAA*A*
*A*****A*
*AAAAAAG*
*********
