*********
*AAAAAAA*
*A*A**A**
*A*AAAAP*
*AA****A*
*AAAAAAA*
*A*******
*AAGAAAA*
*********
