*********
*A*AAA*A*
*A*A*A*A*
*P*A*A*A*
*A*A*A*A*
*A*A*A*G*
*A*A***A*
*AAAAAAA*
*********
