*********
*AAPAAAA*
*******A*
*AAAAAAA*
*A*A*A***
*A*GAAAA*
*A*A**AA*
*AAA*AAA*
*********
