*********
*AAPAA*A*
*A**AA*A*
*AAA*AAA*
*A*A***A*
*A*AAA*G*
*****A*A*
*AAAAA*A*
*********
