*********
*AAAAPAA*
*A*A*****
*A*AAAAA*
*A***A***
*A*AAA*A*
*A*A*A*A*
*AAA*GAA*
*********
