*********
*AAP*AAA*
*A*A*A*A*
*AAA*AAA*
***A*A***
*A*AAAAA*
*A*A***A*
*AAGAAAA*
*********
