*********
*AAAAAAA*
*A*******
*AAAAAAA*
*A*****A*
*A*AAA*A*
*A***A***
*PAAAAAG*
*********
