*********
*PAAAAAA*
***AA****
*A*AAAAA*
*A*****A*
*A*AAGAA*
*A*AA**A*
*AAA*AAA*
*********
