*********
*AAAAPAA*
*A*****A*
*AAAAAAA*
**AA*A*A*
*GAA*A*A*
*A*A*A*A*
*A*AAAAA*
*********
