*********
*A*AAAAA*
*A*A*A***
*AAA*AAP*
****A**A*
*AAAAA*A*
*A***A*A*
*AAGAAAA*
*********
