*********
*AAA*AAA*
*A***A*A*
*AAA*P*A*
*A*A*A*A*
*AAA*A*A*
*A*****A*
*AAGAAAA*
*********
