*********
*A*AAAAA*
*AAA*A***
*AAA*AAA*
*A*A***A*
*PAA*AAG*
*A***A*A*
*AAAAA*A*
*********
