*********
*AAAAAAA*
*A****AA*
*AAA*AAA*
*A*A*A*A*
*G*A*AAA*
*A*A***A*
*A*AAA*P*
*********
