*********
*G*AAAAA*
*A***A*A*
*AAA*A*A*
*A*AA**A*
*P*AAAAA*
*A*A*A*A*
*AAAAA*A*
*********
