*********
*P*AAAAA*
*A*AAA***
*AAA*AAA*
*A*****A*
*AAAAAAA*
***A*A*A*
*GAA*A*A*
*********
