*********
*     * *
* * *** *
*G      *
* ** ** *
*       *
* ****  *
*      P*
*********
