*********
*AAAAAAA*
*A*****A*
*AAA*P*A*
***A*A***
*AAA*AAA*
*A*****A*
*AAGAAAA*
*********
