*********
*PAAAAAA*
*A*****A*
*A*AAA*A*
*AA**AA**
*AAG*AAA*
*A*A***A*
*A*AAAAA*
*********
