*********
*A*AAAAA*
*A***A*A*
*GAAAA*P*
**A**A*A*
*A*AAA*A*
*A*A*A*A*
*AAA*AAA*
*********
