*********
*       *
* ***** *
*  G    *
* **  * *
*     * *
* ***** *
*      P*
*********
