*********
*   *   *
*** * * *
*  G* * *
* *** * *
*     * *
* * * * *
*  P*   *
*********
