*********
*    P  *
* *** ***
* * *   *
* * *****
* *     *
* * *** *
*G  *   *
*********
