*********
*AAAAPAA*
*AAAA****
*A*A*AAA*
*AAA*A*A*
*G*AAA*A*
*A*****A*
*AAAAA*A*
*********
