*********
*AAAAAAA*
*****AAA*
*AAAAG*A*
*A*******
*AAA*AAA*
*A*A***A*
*A*AAPAA*
*********
