*********
*AAAAPAA*
*A*AA**A*
*A*AAA*A*
*AA**A*A*
*GAAAAAA*
*******A*
*AAAAAAA*
*********
