*********
*AAAAPAA*
*A*****A*
*AAA*A*A*
***A*AAA*
*AAAAA*A*
*A*****A*
*A*GAAAA*
*********
