*********
*AAGAAAA*
*A*A***A*
*A*A*AAA*
*A*A*A***
*AAA*AAP*
*A*A*AAA*
*A*AAA*A*
*********
