*************
* *  G      *
* * ***** * *
*   *       *
*****  **** *
*     *     *
*  ** * *** *
*  P* *   * *
* * * *** ***
* * *   *   *
* * *** *** *
* *         *
*************
