*************
*  P  *     *
* * *       *
* *     * * *
* **  *** * *
*     *     *
* ***** *** *
*     * *   *
*** * ***** *
*G  *     * *
*   *   * * *
*     *     *
*************
