*************
*AAA*A*AAAAA*
***A*A*A*A***
*AAA*A*A*AAA*
*A***A*AA*AA*
*A*PAA*AAA*A*
*A*A**A**A*A*
*AAA*AAA*A*G*
*A*A*A*A*A*A*
*A*AAA*A*A*A*
*A*A***A***A*
*AAA*AAAAAAA*
*************
