*************
*AAAAAAGAAAA*
*A**A******A*
*AAAAA*AAA*A*
*A***A*AA**A*
*A*AAA*AAAAA*
*A*AAA*******
*A*A*A*AAAAA*
*A*A*A**A**A*
*A*A*A*AAPAA*
*A*AA**AAAA**
*A*AAAAAAAAA*
*************
