*************
*           *
* * ***** ***
*P  *   *   *
****  * *** *
*   * * *  G*
* * * * *  **
* *   * *   *
* * * ***** *
* *   *   * *
* ***** * * *
*       *   *
*************
