*************
*AAAAAAAAA*A*
****AAA*AA*A*
*AAAAA*GAA*A*
*A*A*A*A*A*A*
*A*AAA*AAA*A*
*A*AAA**AA*A*
*A*AAAAAAAAA*
*AA********A*
*A*AAA*AAAAA*
*A*A*A****AA*
*AAA*AAAAAAP*
*************
