*************
*         * *
* *** *** * *
* *   * *   *
* * * * *** *
*   * *G    *
*** *   *   *
*   * * *   *
***** * *****
*   *   *   *
**  * * * * *
*     *P  * *
*************
