*************
*P        * *
*** ***** * *
*   *     * *
* * * * * * *
*     * * * *
* **  * * * *
*  G  * * * *
*** *****   *
* *     * * *
* *   *** * *
*   *       *
*************
