*************
*   *G      *
* * * **  * *
* * * * *   *
* * * *  ** *
* * *       *
* *  **** * *
* *     *P  *
* *** ***** *
*     *     *
* ** ** *** *
*           *
*************
