*************
*AAAAAAAAAAA*
*A***A***AAA*
*AAAAAAA*A*A*
*A***A*A*A*A*
*G*AAA*AAA*A*
***A***A*A*A*
*AAA*AAA*A*A*
*A*****A*AA**
*A*AAA*A*AAA*
*A*A*A*****A*
*AAA*AAAAPAA*
*************
