*************
*   * *     *
* * * * *** *
*     *   * *
* * ** ** * *
* * *     * *
*  ** ***** *
*  P* *    G*
* * * ** ****
* *       * *
* * ***** * *
* *         *
*************
