*************
*           *
* * ***** * *
*P  *       *
* *** * * ***
*   * *     *
*** *  * ** *
*     *  G  *
* * * * *****
* * * *     *
* *** *** * *
*           *
*************
