*************
*AAA*AAAAAAA*
*A*AAA***A*A*
*A*A*GAA*A*A*
*A*A***A*A***
*A*AAA*A*AAA*
*A*A***AA**A*
*A*A*AAA*AAA*
*A*A*A*A*A***
*A*AAAAAAA*A*
*AA********A*
*AAAAPAAAAAA*
*************
