*************
*A*AAAAAAAAA*
*A*AA******A*
*A*AAAAAAA*A*
*AA*A******A*
*AAA*GAAAA*A*
*A*A*A***A*A*
*AAA*AAAAAAA*
*A***A*A*A***
*A*AAAAAAAAA*
*A*A***A*A*A*
*PAAAAAA*AAA*
*************
