*************
*A*PAAAAAA*A*
*A*A***A*A*A*
*AAAAAAAAAAA*
*A*****A*A***
*A*AAAAAAA*A*
*A*A*A*****A*
*A*A*AAAAA*A*
*A*A*****A*A*
*A*AAAAA*AAA*
*AA**A*A*****
*AAAAA*AAAAG*
*************
