*************
*AAAAA*AAAAA*
*A**AA*A*A*A*
*A*AAAAAAG*A*
*A*A*******A*
*A*AAAAA*AAA*
*AAA*A*A*A***
*A*AAAAA*AAA*
*A*A***A***A*
*A*AAAAA*A*A*
*A*A**AA*A*A*
*AAA*AAPAAAA*
*************
