*************
*AAA*A*AAA*P*
*A*A*A*A*A*A*
*A*AAA*A*AAA*
*A***A*****A*
*AAA*AAAAA*A*
*A*AAA*****A*
*AAAAAAAAGAA*
*A***********
*AAA*AAAAAAA*
***A*A*A*AAA*
*AAAAA*AAAAA*
*************
