*************
* *         *
*   * ***** *
*G  *    P* *
* ***** * * *
* *       * *
*    **** * *
* *       * *
*  ****     *
*     * * * *
***** * *** *
*     *     *
*************
