*************
* *    G    *
* * * ***** *
*   *   *   *
* ***** *****
*     *     *
*** * *** * *
*   *     * *
*   * ***** *
*           *
*** * **  * *
*P        * *
*************
