*************
*        P  *
* ***** * * *
*       *   *
***** * * ***
*     *   * *
* *** *** * *
*           *
* *** * **  *
*   * * * * *
* * *** * * *
* *    G*   *
*************
