*************
*PAA*AAA*AAA*
*A*A*A*A*A*A*
*A*A*AAAAAAA*
*A***AA*AA*A*
*A*AAA*AAA*A*
*A*A*A***A*A*
*A*A*AAAAA*A*
*A***A***A*A*
*A*AAA*AAA*A*
*A*A*A***A*A*
*AAA*GAAAAAA*
*************
