*************
*AAPAA*AAAAA*
*AA**A*A**AA*
*A*A*AAA*AAA*
*A*A*****A*A*
*AAA*AAAAA*A*
***A*A**AA*A*
*A*A*A*AAGAA*
*A*A*A*A*A*A*
*A*A*AAAAA*A*
*A*A***A*A*A*
*AAAAA*AAA*A*
*************
