*************
*P*     *   *
* * * * *** *
* * *     *G*
* * * *** * *
* * * *     *
* * * * *** *
*   * *     *
****  ***** *
* *   *   * *
*   * *   * *
*   *   *   *
*************
