*************
*AAAAAAP*AAA*
*****A*A*AAA*
*AAAAA*AAA*A*
*A***A*A***A*
*A*AAA*AAAAA*
*A***A***A*A*
*AAA*AAGAA*A*
*A*A*A**A**A*
*A*A*AAA*AAA*
*A*A***A*A*A*
*A*AAAAA*AAA*
*************
