*************
*AAA*AAAAAAA*
*A***A*A*A*A*
*AAAAA*AAA*A*
*A******A**A*
*PAAAAAA*AAA*
*A*****A*A***
*A*AAAAA*A*A*
*A*AAA*A*A*A*
*A*A*A*A*AAA*
*A*A*A*A***A*
*AAA*A*AAAAG*
*************
