*************
*         * *
* *** *** * *
* *   * *   *
* * *** *** *
* * *       *
*** * *******
*P  * *  G  *
* *** ****  *
* * *       *
*** ******* *
*           *
*************
