*************
*AAAAAAAAA*A*
*A*A***A*A*A*
*A*AAAAAAAAA*
*A*A**AAA**A*
*AAAAAAAAA*A*
***********A*
*AAA*AAAAA*G*
*A***A***AAA*
*A*AAA*A*A*A*
*A*AA**A*A*A*
*PAAAAAA*AAA*
*************
