*************
*           *
* *  **** * *
*         *P*
* * * ***** *
*G        * *
* *** * * * *
*         * *
* *  **** ***
*   *   *   *
* *** * *** *
* *   *     *
*************
