*************
*         * *
* *** *** * *
*     * *   *
* ***** *** *
* *  G    * *
*   *** * * *
*     * *   *
*   *** * * *
*   *     * *
****   * ** *
*          P*
*************
