*************
*AAAAG*AAAAA*
***A*A*A***A*
*AAA*A*AAAAA*
*A***A*****A*
*A*AAAAAAA*A*
*A*******A*A*
*AAAAA*AAAAA*
*A***AA*AA*A*
*AAA*AAA*AAP*
*A***A*A***A*
*AAAAAAA*AAA*
*************
