*************
*AAAAA*AAAAA*
*A*A***A*A***
*AAA*AAA*AAA*
*A*A*A*****A*
*G*AAA*A*AAA*
*A*****A*AA**
*AAAAAAA*AAA*
*******A***A*
*A*AAAAA*AAA*
*A*A***A*A*A*
*AAAAPAA*A*A*
*************
