*************
*AAA*A*AAAAA*
*A*A*A*A***A*
*A*AAA*A*AAA*
*A*****A*A*A*
*AAAAA*A*P*A*
*****A*A*A***
*AAA*AAA*AAA*
*A*A*A***A*A*
*A*AAAAA*A*A*
*A**A******A*
*AAAAGAAAAAA*
*************
