*************
*AAAAAAA*AAA*
*A*A***A***A*
*A*PAAAAAA*A*
*A*A*A***A*A*
*AAAAAAAAAAA*
*A*A*A**A*A**
*A*A*AAA*AAA*
*A*A**AA*A***
*AAAAA*A*A*A*
*A*A*A*A*A*A*
*AAAAA*GAAAA*
*************
