*************
*AAAAA*AAA*A*
*A*A*A*A*A*A*
*A*A*A*A*A*A*
*A*A*AAA*A*A*
*PAAAAAA*GAA*
***AA******A*
*AAA*AAA*AAA*
*A***A*A*A***
*A*AAA*AAA*A*
*A*A*A*A***A*
*AAA*A*AAAAA*
*************
