*************
*AAG*AAAAAAA*
*A*A***AAA***
*AAAAA*A*AAA*
*A***A*****A*
*AAA*AAA*A*A*
*AAAA*AA*A*A*
*AAAAA*AAA*A*
*****A*****A*
*AAAAA*AAPAA*
*A*A*A*A*A*A*
*A*AAAAAAAAA*
*************
