*************
*  P    *   *
* *** * *   *
*   *   * * *
*** * *** * *
*   *     * *
* *** *   * *
*      G    *
*   *********
* *         *
* *** * * ***
*     *     *
*************
