*************
*AAAAA*A*AAA*
*A****AA*A*A*
*AAGAA*A*AAA*
*A*AAA*A*A*A*
*AAA*A*A*A*A*
*A*A*A*A*A*A*
*A*A*A*AAA*A*
*A*A*A*****A*
*A*A*AAAAAAA*
*A*A*******A*
*AAAAAAAAPAA*
*************
