*************
*    G      *
* *** *** * *
* *       * *
* * ***** ***
*       *   *
*** **** ** *
*   *     * *
* *** *     *
* *  P* *   *
*** *** *** *
*   *       *
*************
