*************
*  G        *
*  **** * * *
* *     *   *
* * ***   ***
* *   * *   *
* *** *** ***
*   *       *
* * * * *** *
* * *   * * *
* * *** * * *
*P      *   *
*************
