*************
*A*AAPAAAAAA*
*A*A****AA*A*
*AAA*AAA*A*A*
*A*****A*AA**
*A*AAAAA*AAA*
*A**AAAA***A*
*AAAAA*A*AAA*
*A*A*A*AAA*A*
*AAAAA*A*A*A*
*A*A***A*A*A*
*GAAAAAAAAAA*
*************
