*************
*     *P    *
* *** * *** *
*   *   *   *
*** *** * * *
* *   * * * *
* *** * **  *
*  G  *     *
* ****  * * *
*   *       *
* * ***** * *
*         * *
*************
