*************
*    G*     *
* *** * *** *
* *   * *   *
* * **  * ***
* * *   * * *
* * * * * * *
*P* *   *   *
* * ** **** *
* * *     * *
* * * *** * *
* *     *   *
*************
