*************
*  G  *     *
* ****  * ***
*   *   *   *
*** * ***** *
*   *   *   *
* ****  * ***
*     * *   *
***** * *   *
*     *P  * *
*  ** ** ** *
*           *
*************
