*************
*AAAAAAAAAAA*
*A*A***A*A*A*
*AAA*AAA*A*A*
*A*AAAAA*A*A*
*GAAAA*AAA*A*
*A****A****A*
*A*AAAAA*AAA*
*A*****A*A*A*
*A*AAA*AAA*P*
*A*AAA***A*A*
*AAAAAAAAA*A*
*************
