*************
*AAAAAAAAAAA*
*A***A**A**A*
*A*A*A*AAAAA*
***A*A*A***A*
*AAA*A*AAAAG*
*A***A**AAAA*
*A*AAAAA*A*A*
*AA****A*A*A*
*AAAAAAA*A*A*
*****A***A*A*
*AAAAAAAAPAA*
*************
