*************
* *         *
* * ****  ***
* * *   *   *
*   * * *** *
* *  G*   * *
* * * **  * *
*   *     * *
* ***** * * *
* *     * * *
* * ***** * *
*  P    *   *
*************
