*************
*AAAAA*AAAAA*
*A***A*A***A*
*P*AAAAA*AAA*
*A***A*****A*
*AAA*A*AAAAA*
*AAA*A*A***A*
*A*A*A*AAA*A*
*A*A*A*A*A*A*
*A*A*AAA*AAA*
*A*A*AA**A***
*A*GAAAA*AAA*
*************
