*************
*A*AAAAAAAAA*
*A*A*****A*A*
*A*A*GAA*A*A*
*A*A*A*A*A*A*
*AAAAA*AAA*A*
*A***A***A*A*
*AAA*A*A*AAA*
***A*A*A*A***
*AAA*A*AAA*A*
*A*A*A***A*A*
*AAPAAAAAAAA*
*************
