*************
*           *
* * *** **  *
*G  *   *   *
*** * *** ***
*     * *  P*
*  ***    * *
* *   *     *
*   * **  * *
*   *   * * *
* ***** *** *
*     *     *
*************
