*************
* *         *
* * *** **  *
*  P* *     *
* ***   *** *
*   *       *
***   *** ***
*           *
*  ******** *
*    G*     *
****  * *   *
*       *   *
*************
