*************
*A*AAAAAAA*A*
*AA**A***A*A*
*AAAAA*A*AAA*
*AA****A***A*
*AAA*PAAAAAA*
*AA**A*****A*
*AAAAA*AAAAA*
*A**A****A*A*
*A*AAAAA*AAA*
*A*A***A***A*
*GAA*AAAAAAA*
*************
