*************
*           *
* * * ***** *
* *   * *   *
***** * * ***
*     *  P* *
* ***** *** *
*     *     *
*  **  * ****
*   *       *
* * ** ** ***
*      G    *
*************
