*************
*  G    *   *
*     *** * *
* *         *
* * ***** * *
*       * * *
*  * ** *** *
* *   *     *
* **   **** *
*     *   * *
****    * * *
*       *  P*
*************
