*************
*AAAAAAAAAAA*
*****A*A*A*A*
*AAAAA*A*AAA*
*A****AA*A*A*
*AAG*AAAAAAA*
*A*A*A****A**
*AAAAA*AAAAA*
*A*A**A**A*A*
*AAA*AAA*A*A*
***AAA*AA**A*
*AAAAP*AAAAA*
*************
