*************
*         * *
* * ***** * *
*   *       *
* *** **** **
*   *     *G*
* * ******  *
* * *       *
* * * ** ****
* *         *
* ** * ***  *
*        P  *
*************
