*************
*AAAAAAAAAAA*
***AA**A*****
*AAA*AAA*AAP*
*A***A***A*A*
*AAA*AAAAA*A*
*A*A*****A*A*
*A*AAAAAAA*A*
*A**AA*A***A*
*A*GAAAAAA*A*
*A*A**A*A**A*
*A*AAAAAAAAA*
*************
