*************
*PAAAA*AAA*A*
***A*A*A*A*A*
*AAAAAAAAA*A*
*A*******A*A*
*AAAAAAAAAAA*
*A*A*******A*
*AAA*GAAAAAA*
*A***A*****A*
*AAAAA*AAAAA*
*A*****A***A*
*AAAAAAA*AAA*
*************
