*************
*PAAAAAAAA*A*
*A***A***A*A*
*AAA*A*AAAAA*
*A***A**AA*A*
*A*AAA*AAAAA*
***AA**A*A*A*
*AAA*AAA*A*G*
*A***A***A***
*AAAAAAA*AAA*
*A*********A*
*AAAAA*AAAAA*
*************
