*************
*     *   * *
***** *  ** *
*    G* *   *
* * * * * * *
*     *   * *
* ********* *
*       *   *
* ***** * ***
*P*   *   * *
* *** ** ** *
*           *
*************
