*************
*   *P*     *
*   * * *** *
* * *     * *
* * *** *** *
*           *
* * * ** ** *
* * *       *
* *** ****  *
*     *   * *
* ***** * ***
*    G  *   *
*************
