*************
*AAAAA*GAAAA*
*A*A*A*A***A*
*AAA*AAAAA*A*
*AAA*****A*A*
*A*AAA*AAA*A*
*A***A*****A*
*A*AAAAAAAAA*
*A***********
*A*AAAAAAAAA*
*A*A**A****A*
*PAAAAAAAA*A*
*************
