*************
*           *
* * ******* *
* *     *   *
* *  ** *   *
* * *    G* *
* * * ***** *
* * *   * * *
* * * **  * *
* * *     * *
*   *  ** * *
*P*   *     *
*************
