*************
*       *   *
***   * *   *
*   *   *   *
* ***   * * *
*     * * * *
* *** *** * *
* * *       *
* * **** ** *
*P      *G  *
****  *** * *
*     *   * *
*************
