*************
*AAAAAAAAAAA*
*A*****A***A*
*AAAAAAAAAAA*
***AA****A***
*AAAAA*AAA*A*
*A*****A***A*
*A*AAA*AAAAA*
*A*A*A*****A*
*P*A*AAAAAAA*
*A*A******A**
*AAAAAAAAAAG*
*************
