*************
*       *   *
* ** **   * *
*     *     *
*   * ***** *
*  P* *   * *
***** *** * *
*   * * * * *
* * *     * *
*     * *   *
* * **  * ***
*      G*   *
*************
