*************
*AAA*AAAAAAA*
*A*A*A*A*****
*A*AAA*P*AAA*
*AAA***AAA*A*
*AAAAA*AAA*A*
*A*********A*
*AAAAAAAAA*A*
*A****A**A*A*
*A*AAAAA*AAA*
*A*A**AA*A*A*
*AAGAA*A*AAA*
*************
