*************
*           *
******* *** *
*       *  P*
* ********* *
*         * *
* ***** * ***
* *   * *   *
*** * * *** *
*   *  G*   *
* *****   * *
*     *   * *
*************
