*************
*AAA*AAGAA*A*
*A*A*A****AA*
*A*AAA*A*AAA*
*A*A***A*A*A*
*A*AAA*AAA*A*
*AAA*A*AA*AA*
*A*A*A*P*AAA*
*A*A*AA**A*A*
*A*AAAAA*A*A*
*A*A***A*A*A*
*AAA*AAAAA*A*
*************
