*************
*    P      *
* *** ***** *
* *     *   *
* *   ***  **
*   * *     *
*   * * * ***
*   *       *
*   *** * * *
* *   * *G  *
* **  **  ***
*   *       *
*************
