*************
*   *   *   *
* *** * *** *
* *   *P    *
* ** * **** *
*     *     *
* ***   *   *
* *   * *   *
* *  ** * ***
* *   * *   *
*  ** * * * *
*G  *     * *
*************
