*************
*AAAAGAAAAAA*
*AA**A*A***A*
*AAAAAAA*AAA*
*A***A**AA*A*
*AAA*AAA*AAA*
*A*A*A*A**AA*
*AAAAA*A*AAA*
*******A*A***
*AAAAAAA*A*A*
*AAA*A***A*A*
*A*AAAAAAPAA*
*************
