*************
*   *   *   *
*** * * *** *
*     *     *
* * * * * * *
* * *  G*   *
* * ******* *
* *   *     *
* ****  *** *
*     *     *
* *** *  ** *
*        P  *
*************
