*************
*           *
*** *** * * *
*       * * *
* ******* * *
* *    G  * *
*   *** * * *
*   * *     *
* * *  ******
*   *       *
* * ** ***  *
* *P        *
*************
