*************
*  P  *     *
* *   * *** *
*   * *   * *
* * **  * * *
* * *   *   *
* * * ***   *
*     *   * *
* * * * *** *
* * * *  G* *
* **  *** ***
*       *   *
*************
