*************
*   *   *   *
*** * * * ***
*P* * * *   *
* * * * *** *
*     *     *
* *******   *
*       *  G*
* * ****  * *
* *   *     *
* *** * * ***
*   *       *
*************
