*************
*   *       *
* * *  ** * *
* *       * *
******** ** *
*P          *
* *  ** *** *
* * *       *
* ***** * ***
* *     * *G*
* * ***** * *
*   *       *
*************
