*************
*           *
* *** ***** *
*   *G*   * *
*   *** * ***
* *   * *   *
* *** * *****
*   * *     *
* * * * *** *
* * *   *P  *
* * ***** * *
*           *
*************
