*************
*AAA*AAAAAAA*
***A*A*A*A***
*AAA*A*AAAAA*
*A***A*******
*A*AAA*AAAAA*
*A*A***A***A*
*PAA*AAAAA*G*
*A*A*****A*A*
*AAAAAAAAAAA*
*A*A******AA*
*AAAAAAAAAAA*
*************
