*************
*           *
**  * ***** *
*   *       *
* *** *** ***
*   *     * *
* * *** * * *
* * *   *G  *
*** * *** * *
*P  * * *   *
* *** *  ** *
*     *     *
*************
