*************
*        P  *
* **** ** * *
*     *   * *
* *** * * * *
*   *   *   *
***** * *** *
*     * * *G*
* *  ** * * *
*           *
********* ***
*           *
*************
