*************
*   *     * *
*  ** *** * *
*   * *     *
***   *** * *
* * *   *G  *
*   * * *****
* *   *     *
* * * *** * *
*   *   * * *
* ***    ** *
*     *P    *
*************
