*************
*       *   *
*  ** * * ***
*   *G* *   *
* * * * *** *
*   * *   * *
* *** *** * *
* *   *   * *
* *** * *** *
*   * *   * *
* * * * * * *
* * *P      *
*************
