*************
*   *     * *
* * * *** * *
*G    * *P  *
* * ***     *
* *   *   * *
* * *** **  *
* * *       *
* *** **  * *
*     *   * *
* ********* *
*           *
*************
