*************
*       *   *
*** *** * * *
*       *G* *
* *** *** ***
*   * *     *
* *   *** * *
* * *   * * *
***  *  *** *
*   * *     *
*   * * *** *
*   *  P    *
*************
