*************
*AAAAAAPAA*A*
*A*********A*
*AAA*A*AAAAA*
***A*A*AAA***
*AAA*A*AAAAA*
*A***A*AA*AA*
*AAA*AAA*AAA*
*A*A*A**AA*A*
*A*A*A*GAAAA*
*A*A***A***A*
*AAAAAAA*AAA*
*************
