*************
*AAP*AAAAAAA*
*AAA*A**AA*A*
*A*AAA*AAA*A*
*A*****A***A*
*A*AAAAA*AAA*
*A*A*****A***
*A*AAAAAAGAA*
*A***A*AA*AA*
*A*AAA*AAA*A*
*AAA****AA*A*
*A*AAAAAAA*A*
*************
