*************
*       *   *
*   ***** * *
* *     * * *
* * * * * ***
* *   * *  P*
* ***** *** *
*  G    *   *
* ***   *   *
* * * * * * *
* *   * *   *
*   *     * *
*************
