*************
*   *       *
* **  * * * *
*     *   * *
* ******* * *
*   *     *G*
*** * ***** *
*     *     *
* *** *** * *
* * * *   * *
* * * * * * *
*   *   *  P*
*************
