*************
*A*AAAAAAAAP*
*A*AAA*A***A*
*AAA*A*AAA*A*
*A*A*A***A*A*
*AAA*AAA*AAA*
***A*A*A***A*
*A*AAA*A*A*A*
*A***AAA*A*A*
*GAAAA*A*AAA*
*A*A**AAAAA**
*A*AAAAA*AAA*
*************
