*************
*AAA*AAAAAAA*
*AAA*A****AA*
*A*A*A*A*AAA*
*AAA*A*A*A*A*
*PAAAAAA*A*A*
*A*****A*AAA*
*AAAAA*AAA*A*
***A*A*A*A***
*AAAAA*A*AAA*
*A***A*A***A*
*AAAAG*AAAAA*
*************
