*************
*     *G    *
***** * * ***
* *   * *   *
* * ****  * *
*   *     * *
* * *** * * *
* *     *   *
* * ******* *
* *         *
* *   *** * *
*    P  *   *
*************
