*************
*AAAAAAAAAAA*
*A*A*******A*
*A*AAAAAAAAA*
*A*A*A*A***A*
*A*GAAAAAA*A*
*********AAA*
*AAA*AAA*A*A*
*A***A*A*A*A*
*A*AAA*A*AAA*
*A*A*A*A***A*
*AAA*AAPAAAA*
*************
